Yokutsan	Yokutsan	**hv:Campbell:1997**	
Karuk	Karuk	**hv:Campbell:1997**	
Yurumangui	Yurumanguí	**hv:Adelaar:Andes**	
East_Kutubu	East Kutubu	**hv:Franklin:KutubuanEngan**	The link to Fasu is premature because counting framework and kinship terms are precisely the kind of argument that is not conclusive of a genetic relationship **hv:Franklin:KutubuanEngan**:311.
Kamakanan	Kamakanan	**hvw:Silva:Kamaka**	The lexical similarities to Jê and Fulniô adduced by Loukotka **hv:Loukotka:Kamakan** remain to be corroborated using Kamakanan proto-forms **hvw:Silva:Kamaka**.
Kakua-Nukak	Kakua-Nukak	**v:Bolanos:Kakua-Puinave**, **v:BolanosEpps:Kakua**	
Yuki-Wappo	Yuki-Wappo	**hvb:Golla:California**:192-193	
Meroitic	Meroitic	**hv:Rilly:Meroitique**, **hv:Rowan:Meroitic**	The best case for an Eastern Sudanic (of Nilo-Saharan) affilition is **hv:Rilly:Meroitique**, but the comparisons where the meaning of the Meroitic word is known independently, are too few to be convincing, and the comparisons where the meaning of the Meroitic word is not known but inferred from the comparisons, are circular.
Huavean	Huavean	**hv:Campbell:1997**	
Barbacoan	Barbacoan	**hv:CurnowLiddicoat:Barbacoan**	Also includes Cañari **vld:Howard:Canari**.
Gumuz	Gumuz	**s:Bender:Gumuz**, **w:Bender:Gumuz**	Gumuz doesn't not show much in the way of alleged Nilo-Saharan features **s:Bender:Gumuz**, **w:Bender:Gumuz**.
Caddoan	Caddoan	**hvw:Parks:Northern-Caddoan**	
Saharan	Saharan	**hv:Cyffer:Saharan**, **hv:Cyffer:Ancestors**, **hv:Chonay:Teda-Kanuri**, **hv:Awagana:Sahariennes**	No conclusive, methodologically sound basis for assigning Saharan to an alleged full or partial Nilo-Saharan has been presented **hv:Blench:Nilo-Saharan**, **hv:Bender:Nilo-Saharan:2000**, **hv:Boyeldieu:Nilo-Sahariennes**.
Andaqui	Andaquí	**hv:Adelaar:Andes**	
Savosavo	Savosavo	**hv:Terrill:CSolomon**, **hv:DunnTerrill:Central-Solomons**	
Maiduan	Maiduan	**hv:Campbell:1997**	
Worrorran	Worrorran	**hv:McGregorRumsey:Worrorran**	
Huarpean	Huarpean	**hv:Adelaar:Andes**	
Tunica	Tunica	**hv:Campbell:1997**	
Dizoid	Dizoid	**hv:Theil:Omotic:2012**	The resemablances between Dizoid and Ta-Ne-Omotic languages (especially Bench) are best explained as loans **hv:Theil:Omotic:2012**:373-374. Dizoid features no other reason or diagnostic features to be classified as Afro-Asiatic **hv:Hayward:Omotic:2004**, **hv:Bender:Omotic**, **hv:Bender:Omotic:Lexicon**, **hv:Theil:Omotic**, **hv:Bender:Omotic:2010**, **hv:Theil:Omotic:2012**.
Lavukaleve	Lavukaleve	**hv:Terrill:CSolomon**, **hv:DunnTerrill:Central-Solomons**	
Kungarakany	Kungarakany	**hv:Evans:Non-Pama-Nyungan**, **hv:Evans:Australia**	Evidence for an Arnhem family or a Gunwinyguan affiliation is not sufficient.
Morehead-Wasur	Morehead-Wasur	**hv:Wurm:Trans-Fly**	Wurm's arguments **hv:Wurm:Trans-Fly**:327-335 appear to be unreliable lexicostatics and typological features.
Dravidian	Dravidian	**hv:Krishnamurti:Dravidian**	There appear to be no data to the effect that Bazigar Boli is a Dravidian language **e:Singh:Bazigar**
Western_Daly	Western Daly	**hv:Evans:Non-Pama-Nyungan**:13 **hv:ReidGreen:Daly** **g:Ford:Emmi**	
Tanahmerah	Tanahmerah	**hv:Ross:Pronouns** **hvld:Voorhoeve:CWTNG**:424-431	Links with Mairasi are unconvincing lexically and pronominally **hvld:Voorhoeve:CWTNG**:424-431.
Northern_Daly	Northern Daly	**hv:Evans:Non-Pama-Nyungan**:13 **hv:ReidGreen:Daly**	
Bangi_Me	Bangi Me	**w:Blench:BangiMe**	
Kamula	Kamula	**hv:Reesink:Aramia**:13-18 **s:Routamaa:Kamula**:7	
Duranmin	Duranmin	**hvld:LaycockZGraggen:Sepik-Ramu**, **hvw:ConradDye:USepik**, **hvw:ConradLewis:USepik**	Typological arguments are not sufficient to conclude a Leonard Schultze family with Walio **hvld:LaycockZGraggen:Sepik-Ramu**. Neither is the shared animate-suffix with Walio conclusive of a genetic relation **hvw:ConradLewis:USepik**. The lexical evidence does not show any conclusive genetic relationship either, be it inside or outside Leonard Schultze **hvw:ConradDye:USepik**, or with Papi **hvw:ConradLewis:USepik** (a higher figure (29\%) of Papi-Duranmin lexicostatistical relations quoted by Laycock earlier, is superseded by the later, below 10\%, figures of Conrad and Lewis).
Fasu	Fasu	**hv:Franklin:KutubuanEngan**	The link to East Kutubuan is premature because counting system and kinship terms are precisely the kind of argument that is not conclusive of a genetic relationship **hv:Franklin:KutubuanEngan**:311.
Esselen	Esselen	**hv:Campbell:1997**	
Kehu	Kehu	**vw:Kamholz:Keuw**	There are some parallels with Lakes Plain languages drawn up in **hv:Whitehouse:Lost**.
Yurakare	Yurakare	**g:vanGijn:Yurakare**	
Algic	Algic	**hv:Goddard:Algonquian-Wiyot-Yurok** **hv:Goodard:Algonquian** **hvb:Golla:California**	
Dogon	Dogon	**hv:Bendor-SamuelOlsenWhite:Dogon**, **hw:Hochstetler:Dogon**	Dogon has not yet been shown to contain systematic sound correspondences, noun class systems or verbal extensions to Niger-Congo in some form. Baŋgi Me is taken out of Dogon in view of **w:Blench:BangiMe**.
Otomaco	Otomaco	**hv:Adelaar:Andes**	
Elseng	Elseng	**hvw:Voorhoeve:Miscellaneous**	
Mirndi	Mirndi	**hv:Harvey:Mirndi**	
Nuclear_Torricelli	Nuclear Torricelli	**h:Foley:2000**, **hvw:Crowther:WWapei**, **hvsoc:SandersSanders:Marienberg**	No evidence for the Bogia (Monumbo) languages being related to other Torricelli languages was ever presented **hv:Laycock:Torricelli**. The low lexicostatistical figures from Wom [wmo] **hv:GlasgowLoving:Maprik**:8 notwithstanding, inspection of Wom lexicon shows many obvious correspondences with Torricelli languages (I wish to thank Tim Usher and Matthew Dryer for convincing me of this) but the wide range of lexicostatistical similarity between Wom and various Arapeshan and Kombioic languages suggests than many items are borrowed, so do not constitute unequivocal evidence for subgrouping Wom with Kombioic and Arapeshan.
North_Bougainville	North Bougainville	**hvtyp:DunnReesinkTerrill:EPapuan**, **hv:Terrill:EPapuan** **g:Robinson:Rotokas**:17-24	
Maratino	Maratino	**hv:Campbell:1997**	
Kujarge	Kujargé	**hvw:DoornbosBender:Wadai-Darfur**	
Mura-Piraha	Mura-Pirahã	**g:Everett:Piraha:1986**	
Hibito-Cholon	Hibito-Cholon	**hv:Adelaar:Andes**:461-463	
Nadahup	Nadahup	**g:Epps:Hup**:5-9 **hv:Martins:Protomaku-Oriental**, **v:BolanosEpps:Kakua**	
Candoshi-Shapra	Candoshi-Shapra	**hv:Adelaar:Andes**	
Anson_Bay	Anson Bay	**hv:Evans:Non-Pama-Nyungan**:13 **hv:ReidGreen:Daly** **g:Ford:Emmi**	
Peba-Yagua	Peba-Yagua	**hv:Pena:Peba-Yaguan**, **hv:GildeaPayne:Macro-Carib**	
Shom_Pen	Shom Pen	**w:Blench:ShomPen**	The language described in **w:Blench:ShomPen** has a vocabulary that is clearly not cognate with Austroasiatic, though there are question marks for some of the data.
Katla-Tima	Katla-Tima	**hv:Schadeberg:Kordofanian**	Katla and Tima are related **hvs:Stevenson:Nuba**:190-196. There is no reason to adhere to the suggestion of a relationship to Heiban, Narrow Talodi, Tegem or Rashad **hv:Schadeberg:Kordofanian**, **hv:Schadeberg:Kordofanische**, since there are no noun classes and the lexical evidence is weak in the extreme **hv:Blench:Kordofanian**.
Kadugli-Krongo	Kadugli-Krongo	**hv:Dafalla:Katcha-Kadugli**	
Temein	Temein	**hvs:Stevenson:Nuba**, **hv:Blench:Temein**	No conclusive, methodologically sound basis for assigning Temein to Eastern Sudanic **hv:Bender:ESudanic** or to an alleged full or partial Nilo-Saharan has been presented **hv:Blench:Nilo-Saharan**, **hv:Bender:Nilo-Saharan:2000**, **hv:Boyeldieu:Nilo-Sahariennes**.
Mombum	Mombum	**hvld:Voorhoeve:CWTNG**:396-398	Pronouns do not match sufficiently well for an immediate Trans New Guinea affiliation, and apart from this, there are only capricious lexical similarities to other families **hvld:Voorhoeve:CWTNG**:396-398. Internally, Koneraw and Mombum (aka Komelom) can be seen to be related from the basic vocabulary correspondences in **hw:Geurtjens:Marindineesche**.
Maban	Maban	**hv:Edgar:Maba** **hv:Starostin:Mimi**	No conclusive, methodologically sound basis for assigning Maban to an alleged full or partial Nilo-Saharan has been presented **hv:Blench:Nilo-Saharan**, **hv:Bender:Nilo-Saharan:2000**, **hv:Boyeldieu:Nilo-Sahariennes**. The evidence that Mimi-Nachtigal is Maban is slight but convincing **hv:Starostin:Mimi**.
Molof	Molof	**hvw:Voorhoeve:Miscellaneous**	
Border	Border	**hvld:Voorhoeve:CWTNG** **hvld:DonohueCrowther:NCNG**	Waris, Taikat, Bewani
Somahai	Somahai	**hvw:Voorhoeve:Irian**	No obvious lexical or other significant links with Mek, Western Ok, Awyu-Dumut or Bayono-Awbono.
Kolopom	Kolopom	**hvld:Voorhoeve:CWTNG**	I am unable to find arguments for Trans New Guinea affiliation in **hvld:Voorhoeve:CWTNG** and there is no obvious relation.
Turama-Kikori	Turama-Kikori	**h:Foley:2000** **hv:Franklin:Other**:263-267	
Hmong-Mien	Hmong-Mien	**hv:Ratliff:Hmong-Mien**	
Lencan	Lencan	**hv:Campbell:1997**	Interesting links have been noted with Misumalpan **hv:Costenla:LencasMisumalpas**.
Wiru	Wiru	**hv:Kerr:Wiru**	Wiru shares some cultural vocabulary and some typological features with Engan **hv:Kerr:Wiru** but is otherwise very different **hv:Franklin:Engan**. I am indebted to Tim Usher for bringing to my attention how different Wiru actually is from Engan.
Cahuapanan	Cahuapanan	**hv:Valenzuela:Cahuapana**	
Beothuk	Beothuk	**hv:Campbell:1997**:289-290	
Papi	Papi	**hvld:LaycockZGraggen:Sepik-Ramu**, **hvw:ConradDye:USepik**, **hvw:ConradLewis:USepik**	Typological arguments are not sufficient to conclude a Leonard Schultze family with Walio **hvld:LaycockZGraggen:Sepik-Ramu**. The lexical evidence does not show any conclusive genetic relationship either, be it inside or outside Leonard Schultze **hvw:ConradDye:USepik**, or with Duranmin **hvw:ConradLewis:USepik** (a higher figure (29\%) of Papi-Duranmin lexicostatistical relations quoted by Laycock earlier, is superseded by the later, below 10\%, figures of Conrad and Lewis).
Sahaptian	Sahaptian	**hv:Campbell:1997**	There are interesting parallels to Wintuan and the rest of Plateau Penutian (= Molala and Klamath-Modoc) **hv:Liedtke:WintuanPenutian**.
Otomanguean	Otomanguean	**hv:Campbell:1997** **hv:Suarez:Otomangues-Tlapaneco**	
Iranxe	Iranxe	**hv:DixonAikhenvald:Isolates**	
Arara_do_Rio_Branco	Rio Branco Arara	**el:Souza:Arara**, **w:dAngelis:Arara-Rio-Branco**	There is only a short wordlist for which the majority of entries are not Tupí cognates. Cognates for these words have so far not been uncovered in other families.
Awake	Awaké	**hv:Migliazza:Orinoco**	
Nuclear_Trans_New_Guinea	Nuclear Trans New Guinea	**h:Foley:2000** **hv:Suter:NENG** **hv:Pawley:Chequered-TNG**	Includes Finisterre-Huon **hv:Suter:Finisterre-Huon**, **hv:Suter:Huon**, Irian Highlands (Dani and Paniai Lakes subgroups) **h:Foley:2000**, Madang **h:Foley:2000**, **hv:Daniels:Sogeram**, Ok **h:Foley:2000**, Awyu-Dumut **h:Foley:2000**, Asmat-Kamoro **hv:Voorhoeve:Asmat-Kamoro-Awyu-Dumut-Ok**, **hvtyp:deVries:Dumut**, Oksapmin together with Ok **hv:LoughnaneFedden:Oksapmin-Ok**, Binanderean **hv:Smallhorn:Binanderean-TNG** **hv:Smallhorn:Binanderean**, Eastern Highlands **hv:Xiao:HAB**, Mek **hvw:Heeschen:Mek:1978**, **hvld:Heeschen:Mek:1992**, probable members Engan **h:Foley:2000**, Chimbu **h:Foley:2000**. See also **hv:Pawley:Voorhoeve**:97 and **hv:Ross:Voorhoeve**:146 **hv:Daniels:Sogeram:2015** for re-subgrouping of a few languages. The Bikaru-Bragge wordlist in **hvw:ConradLewis:USepik** presumably represents the Pikaru dialect of Bisorio (an Engan language) despite the divergence of the two, since the body part terms agree and the elicitation sessions were monolingual.
Omurano	Omurano	**hv:Adelaar:Andes**	
Kariri	Kariri	**v:Ribeiro:Kariri**	Evidence for a Macro-Jê affiliation is still insufficient **v:Ribeiro:Kariri**
Chinookan	Chinookan	**hv:Campbell:1997**	
Doso-Turumsa	Doso-Turumsa	**hvw:Shaw:Bosavi**, **el:Tupper:Turumsa**	Turumsa and Dibiyaso are said to share as much as 19\% lexicostatistical similarity **el:Tupper:Turumsa**, but, looking at the items in question and the sociolinguistic situation, a loan scenario is preferable to a genealogical one.
Gunwinyguan	Gunwinyguan	**hv:Evans:Non-Pama-Nyungan**, **hv:Evans:Australia** **g:vanEgmond:Enindhilyakwa**:314-370	Incl.~Ngandi-Nunggubuyu, Anindilyakwa **g:vanEgmond:Enindhilyakwa**:314-370, Rembargic, Gunwinggic, Ngalkbun, Western Gunwinyguan (Jawoyn and Warray) but excluding Maningrida, Kunkarakany, Gaagudju, Mangarrayi, Wagiman and Yangmanic. The evidence for an Arnhem family is not sufficient.
Nambiquaran	Nambiquaran	**g:deAraujo:Sabane**	
Atlantic-Congo	Atlantic-Congo	**hv:WilliamsonBlench:Niger-Congo**	The core is held together by regular sound correspondences in lexical items between subfamily languages, less systematic verbal extensions and noun class systems **hv:Stewart:Potou-Akanic-Bantu**, **hv:Stewart:Three-Grade**, **hv:Becher:Atlantischen**, **hv:WilliamsonBlench:Niger-Congo**, **hv:Mukarovsky:WNigritic**, **hv:PozdniakovSegerer:Atlantiques**, **hv:Hyman:Niger-Congo**, **hv:Holst:Atlantic**. Mande, Kordofanian, Ijoid and Dogon have not yet been shown to stand up to these criteria wherefore they are excluded. The Pre or Mbre language in Côte d'Ivoire, known from wordlists only, is Atlantic-Congo but cannot be assigned to a specific branch at this time **w:Blench:Pre**, **vld:Boukari:Pre**. The Mpra (= Mpre) language in Ghana has cognates with Atlantic-Congo especially Guang **hew:Goody:Guang**, including numerals 2-5, but the bulk of the little vocabulary that is known, is not Atlantic-Congo **w:Blench:Mpra**. On the grounds that the numerals are less likely to be borrowed, and that lexical innovation may produce vocabulary that looks unrelated to anything else, we count Mpra as an Atlantic-Congo language.
Basque	Basque	**v:Trask:Basque**	
Bosavi	Bosavi	**hvw:Shaw:Bosavi**	
Alsea	Alsea	**hv:Campbell:1997**	
Kosare	Kosare	**wsoc:Wambaliau:Kosare**	The lexicon shows no convincing relationship to any of the surrounding languages **wsoc:Wambaliau:Kosare**
Timote-Cuica	Timote-Cuica	**hv:Adelaar:Andes**	
Kanoe	Kanoê (Kapixaná)	**hvw:vanderVoort:Kwaza**	
Yanomamic	Yanomamic	**g:Borgman:Sanuma**	
Western_Tasmanian	Western Tasmanian	**hv:Bowern:Tasmanian**	
Nakh-Daghestanian	Nakh-Daghestanian	**hv:Nichols:Nakh-Dagestanian**	
Pyu	Pyu	**hvw:ConradDye:USepik**	Laycock never presented evidence for a Kwomtari-Baibai-Pyu family **hv:Laycock:SkoKwomtariLeftMay**.
Zaparoan	Zaparoan	**hv:Wise:Zaparos**, **hv:deCarvalho:Zaparoan**	
Kembra	Kembra	**h:Doriot:6234**, **hb:Hammarstrom:Least**	
Guriaso	Guriaso	**hvs:Baron:Kwomtari**	Laycock never presented real evidence for a Kwomtari-Baibai-Pyu family **hv:Laycock:SkoKwomtariLeftMay**. It is clear from the data collected so far **hvs:Baron:Kwomtari** that Guriaso [grx] shares no more lexical cognates with Kwomtari and Biaka than expected at random, and that's not even when borrowing is discounted (Kwomtari neighbours Guriaso). Further correspondences presented are merely typological or random enough to make Japanese a Kwomtari language **hvs:Baron:Kwomtari**:29.
Wakashan	Wakashan	**hv:Stonham:Wakashan**	
Bulaka_River	Bulaka River	**hv:Usher:Bulaka**	Wurm's arguments **hv:Wurm:Trans-Fly**:324 for a Trans-Fly assignment were based on low (ca 9\%) lexicostatistical figures and typological characteristics.
Hattic	Hattic	**s:Klinger:Hattisch**	
Yale	Yalë (Nagatman)	**hv:Laycock:Isolates**	
Tambora	Tambora	**hvw:Donohue:Tambora**	
Giimbiyu	Giimbiyu	**hv:Evans:Non-Pama-Nyungan**	Mangeri and Uningangk are dialects of the same language **hv:Capell:Arnhem**:372.
Salinan	Salinan	**hv:Campbell:1997**	
Athapaskan-Eyak-Tlingit	Athapaskan-Eyak-Tlingit	**hv:Gollaetal:NAmerica**, **hv:Leer:AET**	Interesting well-analysed parallels between Haida, Eyak-Athapaskan and Tlingit have surfaced recently **hv:Enrico:Na-Dene** but do not fit sound correspondences with AET **hv:Leer:AET** and is not enough to conclude a genetic relationship. Similarly, the links to Yeniseic **hv:Vajda:Dene-Yeniseian** is not yet mature enough to conclude a genetic relationship **hv:Campbell:Dene-Yeniseian**, **hv:Starostin:Dene-Yeniseian**.
Charruan	Charrúan	**vw:ViegasJaime:Chana**	
Ijoid	Ijoid	**hv:Jenewari:Defaka**, **hv:Connelletal:Defaka-Ijo**	Ijoid has not yet been shown to contain systematic sound correspondences, noun class systems or verbal extensions with Niger-Congo in some form.
Piawi	Piawi	**hv:Comrie:Piawi**, **hv:Comrie:Yuat**	
Totonacan	Totonacan	**hv:Campbell:1997**, **hv:MacKayTrechsel:Totonacan**	
Pano-Tacanan	Pano-Tacanan	**hv:ValenzuelaZariquiey:Pano-Takanan**	Chunene of **hvw:Montano:Bolivia:II**:1-11 is similar to Ese Ejja and therefore Tacanan (p.c.~Willem Adelaar 2008 and Marine Vuillermet 2015). Yora is mutually intelligible with Yaminahua **e:Shepard:Amazonian**:32-42. The minuscule wordlist in **w:PalauSaiz:Moxos** of Chiriva **hv:Hervas:Catalogo**:250 is probably Panoan
Chimariko	Chimariko	**g:Jany:Chimariko**	
Austronesian	Austronesian	**hv:Blust:Austronesian** **v:Blust:Austronesian**	Insufficient **v:Blust:Austronesian** parallels with Jarawa-Onge can be found in **hv:Blevins:Sister**. Makuva [lva] of East Timor is also Austronesian **sv:vanEngelenhovenCailoru:Makuva**. Utupua, Vanikoro and Reef-Santa Cruz have been shown to be bona fide Oceanic **hv:RossNaess:Temotu**, **hv:NaessBoerger:RSC**, **hvs:Francois:Vanikoro**. The arguments that Warembori, along with Yoke, is Austronesian are in fact convincing **s:Donohue:Warembori**. Also, the best take on the poorly attested Kazukuru language(s) is that they were New Georgia Austronesian **hv:DunnRoss:Kazukuru**.
Lepki-Murkim	Lepki-Murkim	**hb:Hammarstrom:Least**	Though not fortcoming from the lexicostatistical counts in **hwsoc:Wambaliau:Murkim**, looking the actual words in the two languages, there are too many similarities to be mere chance (contra **hb:Hammarstrom:Least**).
Manubaran	Manubaran	**hv:Dutton:SETNG**	Evidence for Trans New Guinea membership **hv:Dutton:SETNG**:624-631 **hv:McElhanonVoorhoeve:TNG** or with other neighbouring families **hv:Dutton:SETNG**:624-631 is clearly insufficient, as the lexical links so far proposed are few and show irregular one-consonant correspondences.
Walio	Walio	**hvld:LaycockZGraggen:Sepik-Ramu**, **hvw:ConradDye:USepik**, **hvw:ConradLewis:USepik**	Typological arguments are not sufficient to conclude a Leonard Schultze family with Papi **hvld:LaycockZGraggen:Sepik-Ramu**. The lexical evidence does not show any conclusive genetic relationship either, be it inside or outside Leonard Schultze **hvw:ConradDye:USepik**, **hvw:ConradLewis:USepik**.
Arawakan	Arawakan	**hv:Aikhenvald:Arawak**	Saraveca, Paiconeca, Aguachile are all bona fide Arawak despite doubts raised by **hvw:Montano:Bolivia:II**:87-173. Magiana  **w:PalauSaiz:Moxos** is clearly an Arawakan language of the Bolivia-Paraná group different from all known languages of that group cf.~**hv:Hervas:Americanas**:249.
Taushiro	Taushiro	**hv:Adelaar:Andes**	
Puelche	Puelche	**hv:ViegasBarros:Chon:2006**, **hv:Casamiquela:Patagonicas**, **hv:ViegasBarros:Patagonia**	The parallels with Chon or Chon-Querandí are interesting but not conclusive.
Dagan	Dagan	**hv:Dutton:SETNG**	Evidence for Trans New Guinea membership **hv:Dutton:SETNG**:624-631 **hv:McElhanonVoorhoeve:TNG** or with other neighbouring families **hv:Dutton:SETNG**:624-631 is clearly insufficient, as the lexical links so far proposed are few and show irregular one-consonant correspondences.
Kxa	Kx'a	**hv:HeineHonken:Kxa** **hv:Guldemann:Khoisan:2014**	
Yeniseian	Yeniseian	**hv:Vajda:Yeniseic**	The link to Eyak-Athapascan-Tlingit **hv:Vajda:Dene-Yeniseian** is not yet mature enough to conclude a genetic relationship **hv:Campbell:Dene-Yeniseian** **hv:Starostin:Dene-Yeniseian**.
Pahoturi	Pahoturi	**hv:Wurm:Trans-Fly**	Wurm's arguments **hv:Wurm:Trans-Fly**:327-335 appear to be unreliable lexicostatics and typological features.
Amto-Musan	Amto-Musan	**hv:Laycock:Isolates**	
Chono	Chono	**hv:Adelaar:Andes**:552-558 **hv:ViegasBarros:Patagonia**	There are lexical parallels with Mapuche as well as Qawesqar **e:Trivero:Chiloe**:82 but the core is clearly unrelated.
Sandawe	Sandawe	**h:Guldemann:2003**	
Minkin	Minkin	**hvw:Evans:Minkin**	Despite **hvw:Evans:Minkin**, the lexical evidence for a relation to Tangkic shows no regular correspondences, and the case does not improve when considering proto-Tangkic rather than the modern Tangkic languages (p.c.~Erich Round 2013).
Waikuri	Waikuri	**s:Zamponi:Waikuri**	
Cayuvava	Cayuvava	**s:Crevels:Itonama**	
Adai	Adai	**hv:Goddard:Southeast-USA**	
Great_Andamanese	Great Andamanese	**hv:Abbi:Andamanese**	
Shabo	Shabo	**s:Teferra:Shabo**, **v:Schnoebelen:Shabo**, **v:Schnoebelen:Shabo:Unclassifying**	
Austroasiatic	Austroasiatic	**hv:vanDriem:Himalayas**, **hv:Pinnow:Austroasiatic**	
Guahiboan	Guahiboan	**hv:Adelaar:Andes**	
Harakmbut	Harakmbut	**hv:Adelaar:Andes**	There are promising lexical links with Katukina **hv:Adelaar:HarakmbutKatukina**, with a fair amount of near-identical forms, but the systems of pronouns, numerals or bound morphology show no cognation.
Turkic	Turkic	**hv:Rona-Tas:Turkic**	
Kenaboi	Kenaboi	**w:Hajek:Kenaboi**	The arguments for considering Kenaboi a taboo-jargon are not compelling **w:Hajek:Kenaboi**, **w:Benjamin:Kenaboi**. Although potential cognates can be found for a fraction of the Kenaboi forms **w:Benjamin:Kenaboi**, they are widely scattered and without systematicity. The simplest explanation is then that Kenaboi is an isolated language and that the similarities to remote branches of Austronesian and Austroasiatic are chance resemblances.
Etrusco-Rhaetian	Etrusco-Rhaetian	**s:Rix:Etruscan:2008**, **hv:Rix:Ratisch**	
Waorani	Waorani	**hv:Adelaar:Andes**	
Nubian	Nubian	**hv:Bechhaus-Gerst:Nubischen**	No conclusive, methodologically sound basis for assigning Nubian to Eastern Sudanic **hv:Bender:ESudanic** or to an alleged full or partial Nilo-Saharan has been presented **hv:Blench:Nilo-Saharan**, **hv:Bender:Nilo-Saharan:2000**, **hv:Boyeldieu:Nilo-Sahariennes**.
Goilalan	Goilalan	**hv:Foley:Papuan**	Evidence for Trans New Guinea membership **hv:Dutton:SETNG**:624-631 **hv:McElhanonVoorhoeve:TNG** or with other neighbouring families **hv:Dutton:SETNG**:624-631 is clearly insufficient, as the lexical links so far proposed are few and show irregular one-consonant correspondences.
Eleman	Eleman	**hvg:Brown:Eleman**	
Klamath-Modoc	Klamath-Modoc	**hv:Campbell:1997**	There are interesting parallels to Wintuan and the rest of Plateau Penutian (= Sahaptian and Molala) **hv:Liedtke:WintuanPenutian**.
Mongolic	Mongolic	**hv:Janhunen:Proto-Mongolic**	See **hv:Vovin:Altaic** for the latest critique of Altaic.
Katukinan	Katukinan	**h:Fabre:2005**	There are promising lexical links with Harakmbut **hv:Adelaar:HarakmbutKatukina**, with a fair amount of near-identical forms, but the systems of pronouns, numerals or bound morphology show no cognation.
Nihali	Nihali	**hv:vanDriem:Himalayas**:242-253 **hv:Zide:Nihali**	
Yeli_Dnye	Yélî Dnye	**typ:Levinson:Yeli-Dnye:Body-Parts**	
Uto-Aztecan	Uto-Aztecan	**hv:Campbell:1997** **hvb:Golla:California**	
Elamite	Elamite	**s:Khacikjan:Elamite**	
Siouan	Siouan	**hv:Campbell:1997**	
Koiarian	Koiarian	**hv:Dutton:Proto-Koiarian**	Evidence for Trans New Guinea membership **hvld:Wurm:ECTNG**:624-631 **hv:McElhanonVoorhoeve:TNG** or with other neighbouring families **hvld:Wurm:ECTNG**:624-631 is clearly insufficient, as the lexical links so far proposed are few and show irregular one-consonant correspondences.
Tuu	Tuu	**hv:Guldemann:Khoisan:2014**	
Kapauri	Kapauri	**wsoc:Rumaropen:Kapauri**, **hb:Hammarstrom:Least**	However, a newer evaluation of the lexical relationships (claimed in **hvw:Voorhoeve:Irian**:45) show no signficant relationship between the Kaure-Narau-Kosare languages and Kapauri **wsoc:Rumaropen:Kapauri**:13.
Molala	Molala	**g:Pharris:Molalla**	There are interesting parallels to Wintuan and the rest of Plateau Penutian (= Sahaptian and Klamath-Modoc) **hv:Liedtke:WintuanPenutian**.
Furan	Furan	**g:Jakobi:Fur**	No conclusive, methodologically sound basis for assigning Furan to an alleged full or partial Nilo-Saharan has been presented **hv:Blench:Nilo-Saharan**, **hv:Bender:Nilo-Saharan:2000**, **hv:Boyeldieu:Nilo-Sahariennes**.
Central_Sudanic	Central Sudanic	**hv:Boyeldieu:CSudanic**, **hv:Boyeldieu:CSudanic:Labiovelar**, **hvw:Boyeldieu:SBB**, **hv:BoyeldieuNougayrol:CSudanic**	No conclusive, methodologically sound basis for assigning Central Sudanic to an alleged full or partial Nilo-Saharan has been presented **hv:Blench:Nilo-Saharan**, **hv:Bender:Nilo-Saharan:2000**, **hv:Boyeldieu:Nilo-Sahariennes**. Birri and the Kresh-Aja group have not yet been shown to be bona fide Central Sudanic **hv:Boyeldieu:CSudanic**.
Fulnio	Fulniô	**h:Fabre:2005**	
Limilngan	Limilngan	**g:Harvey:Limilngan**	
Uhunduni	Uhunduni	**hvw:Larson:Irian-Highlands**	The cognation judgments involving Damal in **hvw:Larson:Irian-Highlands** are overly optimistic in that a match is judged if at least one segment matches. This procedure yields inconsistent sound correspondences. The lexicostatistic argument for relatedness is the only one offered so far, and apart from probable borrowings, we cannot find any cognates in vocabulary or morphology.
Kiowa-Tanoan	Kiowa-Tanoan	**hvbtyp:Sutton:Kiowa-Tanoan**	
Taruma	Taruma	**hv:Loukotka:SAmerica**:150	
Banaro	Banaro	**hvld:Zgraggen:Madang**:163-165 **hv:Foley:Sepik:2013**	Banaro [byz] shows some typological similarities to the Grass, Ap Ma and Ramu languages but there is little lexical evidence **hvld:Zgraggen:Madang**:163-165 **hv:Foley:Sepik:2013**.
Jicaquean	Jicaquean	**hv:Campbell:1997**	
Chibchan	Chibchan	**hv:Constenla-Umana:Chibchan**, **hv:Quesada:Chibchan**	Incl.~Cuna, Chimila, Languages of Sierra Nevada de Santa Maria, Muisca, Tunebo.
Payagua	Payaguá	**hvw:Viegas:Guachi**	The best case for Payaguá relatedness is with Guaycurú and/or Guachi **hvw:Viegas:Guachi** but the parallels are still insufficient.
Marrku-Wurrugu	Marrku-Wurrugu	**hv:Evans:Marrku**, **vw:Evans:Wurrugu**	The evidence for including Marrku in Iwaidjan is not sufficient as the similarities may well be due to borrowing **hv:Evans:Marrku**. The very poorly attested Wurrugu has lexical correspondences with Marrku rather than the rest of Iwaidjan **vw:Evans:Wurrugu**.
Sechuran	Sechuran	**hv:Cerron-Palomino:Peruana**	There are occasional lexical links to the Tallán language(s) **hv:Adelaar:Andes**:398-400, but the very limited data available is not compelling towards a genetic relationship.
South_Omotic	South Omotic	**hv:Lamberti:Ari-Banna**, **hv:Bender:Omotic**, **hvw:Tsuge:SOmotic**	(South) Omotic does not show diagnostic Afro-Asiatic features **hv:Hayward:Omotic:2004**, **hv:Bender:Omotic**, **hv:Bender:Omotic:Lexicon**, **hv:Theil:Omotic**, **hv:Bender:Omotic:2010**, and is therefore excluded until such features can be shown. The Mao languages (Hozo, Seze, Bambeshi and Ganza) have not yet been shown to be (North or South) Omotic in morphology and/or core vocabulary, though there are some resemblances with North Omotic **hv:Bender:Mao**, **hv:Bender:Gumuz-Koman-Mao-Omotic**, **hv:Bender:Omotic**, **hv:Bender:Omotic:1975**, **hv:Bender:Omotic:2010**. The evidence for the coherence of North and South Omotic (= Ari-Banna) **hv:HaywardTsuge:Omotic**, **hv:Fleming:Omotic-Cushitic:Lamberti**, **hv:Lamberti:Ari-Banna:1961**, **hv:FlemingLewis:Ari-Banna** is not sufficient **hv:Fleming:Lamberti:Second**, **hv:Lamberti:Ari-Banna**, **hv:Zaborski:Afroasiatic:2007**, **hv:Bender:Omotic:2010**.
Taiap	Taiap	**hsoc:Kulick:Taiap**:61ff	Laycock's assignment to Sepik-Ramu was for mainly typological reasons **hvld:LaycockZGraggen:Sepik-Ramu**:757 and cannot be said to constitute sufficient evidence for an affiliation to any Sepik-Ramu (sub-)family.
Xincan	Xincan	**hv:Campbell:1997** **g:Sachse:Xinka**:49-53	
Kwalean	Kwalean	**hv:Dutton:SETNG**	Evidence for Trans New Guinea membership **hv:Dutton:SETNG**:624-631 **hv:McElhanonVoorhoeve:TNG** or with other neighbouring families **hv:Dutton:SETNG**:624-631 is clearly insufficient, as the lexical links so far proposed are few and show irregular one-consonant correspondences.
Tiwi	Tiwi	**g:Osborne:Tiwi**	
Moseten-Chimane	Mosetén-Chimane	**g:Sakel:Moseten**	
Cochimi-Yuman	Cochimi-Yuman	**hv:Campbell:1997**	
Yerakai	Yerakai	**hvw:ConradDye:USepik**:14 **hv:Aikhenvald:Sepik**	Yerakai shares no significant lexical relations with any Sepik language **hvw:ConradDye:USepik**:14, except Ndu **hv:Laycock:Sepik**:23, but these are arguably loans from the adjacent Iatmul (as of intermarriage) **hvw:ConradDye:USepik**:14 **hv:Aikhenvald:Sepik**. No other argument for a Sepik affiliation in offered **hvld:LaycockZGraggen:Sepik-Ramu**:738 and Yerakai is not mentioned in Foley's re-consideration of the Sepik family **hv:Foley:Sepik-Ramu**.
Tarascan	Tarascan	**hv:Campbell:1997**	
Japonic	Japonic	**g:Pellard:Ogami** **hv:Vovin:Koreo-Japonica**	See **hv:Vovin:Altaic** for the latest critique of Altaic.
Umbugarla	Umbugarla	**hv:Evans:Australia**	Dixon's suggestion **h:Dixon:Australian2002** received a shattering review by Evans **hv:Evans:Australia**. It has been suggested that Ngurmbur and Bugurnidja were dialects of, or related to, Umbugarla **g:Harvey:Gaagudju**:14 but no data for these are actually attested (p.c.~Nicholas Evans and Mark Harvey 2013).
Kwomtari-Nai	Kwomtari-Nai	**hvs:Baron:Kwomtari**	Laycock never presented real evidence for a Kwomtari-Baibai-Pyu family **hv:Laycock:SkoKwomtariLeftMay**. The membership is Kwomtari [kwo], Biaka/Nai [bio] and not Fas [fqs] as many sources have erroneously repeated. It is clear from the data collected so far **hvs:Baron:Kwomtari** that Guriaso [grx] shares no more lexical cognates with Kwomtari and Biaka than expected at random, and that's not even when borrowing is discounted (Kwomtari neighbours Guriaso). Further correspondences presented are merely typological or random enough to make Japanese a Kwomtari language **hvs:Baron:Kwomtari**:29.
Nara	Nara	**hvs:Stevenson:Nuba**	No conclusive, methodologically sound basis for assigning Nara to Eastern Sudanic **hv:Bender:ESudanic** or to an alleged full or partial Nilo-Saharan has been presented **hv:Blench:Nilo-Saharan**, **hv:Bender:Nilo-Saharan:2000**, **hv:Boyeldieu:Nilo-Sahariennes**. More recent more narrow parallels are suggestive but not enough to be conclusive **hv:Rilly:Nara**.
Oti	Oti	**g:Ribeiro:Karaja**:263-264	
Sause	Sause	**hb:Hammarstrom:Least**	
Nivkh	Nivkh	**hv:Fortescue:Nivkh-Chukotko-Kamchatkan**	Parallels to Chukotko-Kamchatkan are insufficient to conclude a genealogical relationship **hv:Fortescue:Nivkh-Chukotko-Kamchatkan**
Karami	Karami	**hv:UsherSuter:Anim**:125	
Ta-Ne-Omotic	Ta-Ne-Omotic	**hv:Theil:Omotic:2012**	(North) Omotic does not show diagnostic Afro-Asiatic features **hv:Hayward:Omotic:2004**, **hv:Bender:Omotic**, **hv:Bender:Omotic:Lexicon**, **hv:Theil:Omotic**, **hv:Bender:Omotic:2010**, **hv:Theil:Omotic:2012**, and is therefore excluded until such features can be shown. The Mao languages (Hozo, Seze, Bambeshi and Ganza) have not yet been shown to be (North or South) Omotic in morphology and/or core vocabulary, though there are some resemblances with North Omotic **hv:Bender:Mao**, **hv:Bender:Gumuz-Koman-Mao-Omotic**, **hv:Bender:Omotic**, **hv:Bender:Omotic:1975**, **hv:Bender:Omotic:2010**. The evidence for the coherence of North and South Omotic (= Ari-Banna) **hv:HaywardTsuge:Omotic**, **hv:Fleming:Omotic-Cushitic:Lamberti**, **hv:Lamberti:Ari-Banna:1961**, **hv:FlemingLewis:Ari-Banna** is not sufficient **hv:Fleming:Lamberti:Second**, **hv:Lamberti:Ari-Banna**, **hv:Zaborski:Afroasiatic:2007**, **hv:Bender:Omotic:2010**, **hv:Theil:Omotic:2012**. The resemablances between Dizoid and Ta-Ne-Omotic languages (especially Bench) are best explained as loans **hv:Theil:Omotic:2012**:373-374.
Chiquitano	Chiquitano	**wphon:Santana:Chiquitano**	
Larrakiyan	Larrakiyan	**hv:Evans:Non-Pama-Nyungan**, **hv:Evans:Australia**	
Shastan	Shastan	**hvb:Golla:California**	
Kiwaian	Kiwaian	**hv:Foley:Papuan**	
Lower_Sepik-Ramu	Lower Sepik-Ramu	**hv:Foley:Sepik-Ramu**	Ap Ma [kbx] shows some typological similarities to the Grass and Ramu languages but there is little lexical evidence **hvld:Zgraggen:Madang**:168-169 **hv:Foley:Sepik:2013**. Banaro [byz] shows some typological similarities to the Grass and Ramu languages but there is little lexical evidence **hvld:Zgraggen:Madang**:163-165 **hv:Foley:Sepik:2013**.
Tupian	Tupían	**hv:Rodrigues:Tupi**, **hv:Rodrigues:Proto-Tupi**, **hv:Gabas:Tupian**, **hv:Rodrigues:Tupi:Rondonia**, **hv:Rodrigues:Tupi-Guaranis:Impuras**, **hv:Dietrich:Karitiana-Tupi-Guarani**, **hv:Rodrigues:Tupi:Prehistoric**, **hv:Correa-da-Silva:Tupi**, **hv:Rodrigues:Proto-Tupi:Consoantes**	There is parallel in relational prefix with Carib and (Macro-Je) which is suggestive but not conclusive **hv:Rodrigues:Tupi-Karib-Je**
Keresan	Keresan	**hv:Campbell:1997**	
Konda-Yahadian	Konda-Yahadian	**hvtyp:BerryBerry:SBH** **hvld:Voorhoeve:CWTNG**:437-446	Evidence for inclusion in Trans New Guinea is weak **hvld:Voorhoeve:CWTNG**:437-446, especially lexically. The same can be said for a relation with South Bird's Head, Konda-Yahadian and any West Papuan affiliation **hvtyp:BerryBerry:SBH**.
Afro-Asiatic	Afro-Asiatic	**hv:Hayward:Afroasiatic**, **hv:Satzinger:Egyptian**, **hv:Voigt:Hamitic**, **hv:Takacs:Afro-Asiatic**	Omotic (be it South Omotic, North Omotic, Dizoid, or Mao) does not show diagnostic Afro-Asiatic features **hv:Hayward:Omotic:2004**, **hv:Bender:Omotic:Morphology**, **hv:Bender:Afrasian:Lexicon**, **hv:Bender:Omotic**, **hv:Bender:Omotic:Lexicon**, **hv:Theil:Omotic**, **hv:Bender:Omotic:2010**, **hv:Theil:Omotic:2012**, and is therefore excluded until such features can be shown.
Wintuan	Wintuan	**hv:Campbell:1997**	There are interesting parallels to Plateau Penutian (= Klamath-Modoc, Sahaptian and Molala) **hv:Liedtke:WintuanPenutian**.
Chocoan	Chocoan	**hv:AguirreLicht:Choco**	
Koam	Koam	**hv:Foley:Sepik-Ramu**, **hv:Laycock:Sepik**	The three languages are closely related (hinted at by Laycock, and confirmable in the unpublished wordlists). What little data on Mongol-Langam-Yaul that was available to Foley in connection with his demonstration of the Lower Sepik-Ramu family, it was not sufficient for a genetic relationship with Lower Sepik-Ramu. Sufficient argumentation for a relation with the Yuat languages is wanting **hv:Laycock:Sepik**.
Jarawa-Onge	Jarawa-Onge	**hv:Abbi:Andamanese**	Tantalizing, but insufficient, parallels with Austronesian can be found in **hv:Blevins:Sister**.
Tinigua	Tinigua	**hv:Adelaar:Andes**	
Jarrakan	Jarrakan	**hv:McConvell:Jarragan**, **hvtyp:McGregor:Kimberley**	
Blue_Nile_Mao	Blue Nile Mao	**hv:Bender:Omotic**, **hv:Bender:Mao**, **hv:Fleming:Proto-Mao**	The Mao languages (Hozo, Seze, Ganza, and Bambeshi) have not yet been shown to be Omotic in morphology and/or core vocabulary, though there are some resemblances with North Omotic.
Chitimacha	Chitimacha	**hv:Campbell:1997**	
Lengua-Mascoy	Lengua-Mascoy	**hv:UnruhKalisch:Enlhet-Enenlhet**	
Kunama	Kunama	**g:Bohm:Kunama**	No conclusive, methodologically sound basis for assigning Kunama to an alleged full or partial Nilo-Saharan has been presented **hv:Blench:Nilo-Saharan**, **hv:Bender:Nilo-Saharan:2000**, **hv:Boyeldieu:Nilo-Sahariennes**.
Pama-Nyungan	Pama-Nyungan	**hv:Alpher:Pama-Nyungan**, **hv:Alpheretal:WTorres**, **hv:Koch:Pama-Nyungan-Inflectional**	Incl.~the Western Torres Strait language **hv:Alpheretal:WTorres**
Warao	Warao	**g:Romero-Figeroa:Warao**	
Pauwasi	Pauwasi	**hvw:Voorhoeve:Miscellaneous**	Karkar-Yuri is an Eastern Pauwasi language as is evident by inspection of wordlists (see **hb:Hammarstrom:Least** for a history of this discovery). Occasional Pauwasi lexical items and pronoun forms show TNG likeness **hv:WurmMcElhanon:Papuan**:155-156, **hvld:Voorhoeve:CWTNG**:418-419, but are not sufficient to conclude a relationship.
Botin	Botin	**hvld:Zgraggen:Madang**:168-169 **hv:Foley:Sepik:2013**	Ap Ma/Botin/Kambot shows some typological similarities to the Grass, Banaro and Ramu languages but there is little lexical evidence **hvld:Zgraggen:Madang**:168-169 **hv:Foley:Sepik:2013**.
Pawaia	Pawaia	**s:Trefry:KumanPawaian**	Despite vocabulary cognacy of 5\% or so, Pawaia was included in Trans-New-Guinea because of pronoun resemblances to Kuman and on typological  similarities. The typological similarities involve function only **s:Trefry:KumanPawaian**, and thus count for nothing. The pronoun resemblances do not generalize to the Chimbu family **hv:Foley:Papuan**:69-71 and match only an \emph{n} anyway, so they are better accounted for as accidental similarities than deep relationship.
Kwaza	Kwazá	**hvw:vanderVoort:Kwaza**	
Guachi	Guachi	**hvw:Viegas:Guachi** **hvw:Montano:Bolivia:II**:196-205	The best case for Guachi relatedness is with Guaycurú **hvw:Viegas:Guachi** but the parallels are still insufficient.
Porome	Porome	**hvld:Franklin:Isolates**	The suggestion of a Kiwai affiliation is based on pronouns only **hv:Ross:Pronouns**.
Narrow_Talodi	Narrow Talodi	**hvw:Schadeberg:Talodi**	Narrow Talodi (exluding Tegem) is held together by pronouns, lexical cognates, and form-meaning resemblances in the noun class systems. Tegem systematically stands out lexically, pronominally, in the noun class system and alleged sound correspondences are often irregular. The alleged noun class form/meaning correspondences to other Kordofanian groups, namely Rashad and Heiban, in **hv:Schadeberg:Kordofanian**, **hv:Schadeberg:Kordofanische** are not convincing as conclusively genetic; As to form, there is much eclectic selection as well as irregular correspondences, and as to meaning, the methodology of finding non-cognate shared class items is highly dubious. Chance resemblance has not been excluded. The lexical evidence for a Kordofanian unity is weak in the extreme **hv:Blench:Kordofanian**. It follows that the arguments presented for a Niger-Congo affiliation are not compelling either.
Ata	Ata	**ld:Yanagida:Ata**	Pronoun resemblances **hvld:Ross:EPapuan** are not enough for concluding a Yele-West New Britain Family.
Miwok-Costanoan	Miwok-Costanoan	**hvw:Callaghan:Utian**	
Inanwatan	Inanwatan	**hv:deVries:Inanwatan**, **hvtyp:BerryBerry:SBH**	
Timor-Alor-Pantar	Timor-Alor-Pantar	**hv:Schapperetal:Timor-Kisar-Alor-Pantar**, **hv:HoltonRobinson:Timor-Alor-Pantar-Position**	The lexical and pronominal evidence for a Trans New Guinea affiliation is much too weak **hv:Pawley:TNG**:683, **hv:Holtonetal:Alor**, cf.~**hv:Pawley:Chequered-TNG**:94-95. The newest comparison of cognates **g:Kratochvil:Abui**:6-11 cannot muster a strong case (correspondences are few, weak and not systematic enough). Likewise, the Bomberai/Alor comparisons in **hv:Hull:Timor** are flimsy.
Atacameno	Kunza	**hv:Adelaar:Andes**	
Trumai	Trumai	**g:Guirardello:Trumai**	
Movima	Movima	**g:Haude:Movima**	
Kimki	Kimki	**hv:Foley:Sepik:2013**, **hb:Hammarstrom:Least**	Evidence for a Sepik affiliation is too scant, though data is very scant too. No convincing lexical relationship with Yetfa-Biksi **hwsoc:Kim:Yetfa**.
Senagi	Senagi	**g:deSousa:Menggwa-Dla**	
Kamsa	Kamsá	**s:Fabre:Kamsa**	
Cofan	Cofán	**hv:Adelaar:Andes**	
Puquina	Puquina	**hvs:Torero:Andes**	
Culli	Culli	**hv:Adelaar:Andes**	
Surmic	Surmic	**hv:Yigezu:Surmic**	No conclusive, methodologically sound basis for assigning Surmic to Eastern Sudanic **hv:Bender:ESudanic** or to an alleged full or partial Nilo-Saharan has been presented **hv:Blench:Nilo-Saharan**, **hv:Bender:Nilo-Saharan:2000**, **hv:Boyeldieu:Nilo-Sahariennes**.
Chonan	Chonan	**hv:ViegasBarros:Chon** **hv:Adelaar:Andes**:556-558 **hv:ViegasBarros:Patagonia**	Tehuelche, Teushen, Selknam, Haush, Querandi.
Sko	Sko	**hvphon:Donohue:Skou**	
Mor	Mor	**hvld:Voorhoeve:CWTNG**	Evidence for inclusion in Trans New Guinea is weak **hvld:Voorhoeve:CWTNG**:431, both lexically and pronominally.
Duna	Duna	**hvld:Voorhoeve:CWTNG**:395-396	Arguments for the relatedness for Duna and Bogaya are given in **hvld:Voorhoeve:CWTNG**:395-396 but pronouns do not match sufficiently well for an immediate Trans New Guinea affiliation, and apart from this, there are only capricious lexical similarities to other families **hvs:Shaw:MtBosavi**.
Sino-Tibetan	Sino-Tibetan	**hv:Handel:Sino-Tibetan** **hv:DeLancey:Sinitic**	Hruso-Aka [hru] is clearly not a Miji dialect as held by **hv:Shafer:Hruso**. The shared lexicon is attributable to loans, and of what remains, there are insufficient Tibeto-Burman parallels for a Tibeto-Burman affiliation **hv:Padun:NAssam**, **hvw:BlenchPost:Arunachal** **hv:Anderson:West-Kameng**, **v:Anderson:Hruso**. The Kamengic group, Puroik, Miju, Mishmic and Koro-Milang show little Tibeto-Burman cognacy, but what they do show is slightly in favour of inheritance (rather than borrowing) since they occur in the basic vocabulary **hvw:BlenchPost:Arunachal**, **hv:Burling:NEIndia**, **hv:PostBlench:Siangic** **hv:Anderson:West-Kameng**, **v:Anderson:Hruso** and in grammar in the case of Koro-Milang **hv:Anderson:West-Kameng**.
Arawan	Arawán	**hv:Dixon:Arawa**, **hv:Dienst:Arawan**	
Canichana	Canichana	**hv:Adelaar:Andes**	
Chumashan	Chumashan	**hv:Campbell:1997**, **hv:Klar:Chumash**	
Paez	Páez	**hv:Adelaar:Andes**	
Salishan	Salishan	**hv:Campbell:1997**	
Abinomn	Abinomn	**h:SilzerClouse:Index**, **hvtyp:DonohueMusgrave:Melanesia**	
Chukotko-Kamchatkan	Chukotko-Kamchatkan	**hv:Fortescue:Chukotko-Kamchatkan**, **hvd:Fortescue:Chukotko-Kamchatkan**	The explanation of a genealogical relationship between Chukotian and Kamchadal is preferable to an areal explanation **hv:Fortescue:Chukotko-Kamchatkan**. Parallels between Nivkh and Chukotko-Kamchatkan are insufficient to conclude a genealogical relationship **hv:Fortescue:Nivkh-Chukotko-Kamchatkan**
Teberan	Teberan	**hv:Wurm:PapuanOceania**	The suggested Pawaian relation is based on lexicostatistics and typological features **hvld:MacDonald:Teberan**, while e.g.~the pronouns do not match systematically **hvld:Wurm:ECTNG**:501-504.
Mochica	Mochica	**hv:Cerron-Palomino:Naimlap**	
Yaruro	Yaruro (Pumé)	**hv:Adelaar:Andes**	
Angan	Angan	**hv:Foley:Papuan**	As has been clear at least since **hvphon:Lloyd:Angan** there are insufficient lexical links to posit a relationship with Trans New Guinea.
Purari	Purari	**hvs:Brown:Eleman:1973**	
Kutenai	Kutenai	**hv:Campbell:1997**	
Matacoan	Matacoan	**hv:CampbellGrondona:Chulupi**, **hv:NonatoSandalo:GuaikuruMatacoBororo**	
Eastern_Daly	Eastern Daly	**hv:Evans:Non-Pama-Nyungan**:13 **hv:ReidGreen:Daly** **hv:Harvey:EDaly:Verb**, **hv:Harvey:EDaly:Object**	
Bunaban	Bunaban	**hv:Evans:Australia**	
Iroquoian	Iroquoian	**hv:Julian:Iroquoian**	
Iberian	Iberian	**h:Correa:Iberica**	
Heiban	Heiban	**hvw:Schadeberg:Heiban**	Heiban is held together by pronouns, lexical cognates, and form-meaning resemblances in the noun class systems, though with a small question mark for Warnang. The alleged noun class form/meaning correspondences to other Kordofanian groups, namely Rashad and Talodi (with Tegem), in **hv:Schadeberg:Kordofanian**, **hv:Schadeberg:Kordofanische** are not convincing as conclusively genetic; As to form, there is much eclectic selection as well as irregular correspondences, and as to meaning, the methodology of finding non-cognate shared class items is highly dubious. Chance resemblance has not been excluded. The lexical evidence for a Kordofanian unity is weak in the extreme **hv:Blench:Kordofanian**. It follows that the arguments presented for a Niger-Congo affiliation are not compelling either.
Pomoan	Pomoan	**hv:Campbell:1997**	
Kaki_Ae	Kaki Ae	**s:Clifton:Kaki**	Similarly, with the proportion of lexicon shared with Kaki Ae, the semantic fields, metalinguistic awareness, relevant sociolinguistic facts favour a borrowing scenario **s:Clifton:Kaki**:33-34. The so-called sound shifts alluded to by **v:Franklin:Kaki-Ae** are, in fact, perfectly predictable loan renderings given the phonemic systems of Eleman (which has no n/l/r-phonemic distinction) and Kaki Ae (which has no t/k distinction).
Anem	Anêm	**hv:Thurston:NWNB**, **hvtyp:DunnReesinkTerrill:EPapuan**, **hv:Terrill:EPapuan**	Pronoun resemblances **hvld:Ross:EPapuan** are not enough for concluding a Yele-West New Britain Family.
Jalaa	Jalaa	**w:Kleinewillinghofer:Jalaa**	
Burmeso	Burmeso	**s:Donohue:Burmeso**	
Ndu	Ndu	**g:Aikhenvald:Manambu**	The Ndu languages do not show cognate gender markers with Sepik while the pronouns show some amount of resemblance **hv:Foley:Sepik-Ramu**:126-139. However, with the extant variety of pronoun forms with the Sepik languages, it is difficult to ascertain beyond-chance relationships. The best resemblance is with Kwoma but there is detailed refutation of the evidence so far presented that Ndu is related to Kwoma-Kwanga (or the rest of Sepik) **g:Aikhenvald:Manambu**. Yerakai shares no significant lexical relations with any Sepik language **hvw:ConradDye:USepik**:14, except Ndu **hv:Laycock:Sepik**:23, but these are arguably loans from the adjacent Iatmul (as of intermarriage) **hvw:ConradDye:USepik**:14 **hv:Aikhenvald:Sepik**.
Hadza	Hadza	**h:Guldemann:2003**	
Yareban	Yareban	**hv:Dutton:SETNG**	Evidence for Trans New Guinea membership **hv:Dutton:SETNG**:624-631 **hv:McElhanonVoorhoeve:TNG** or with other neighbouring families **hv:Dutton:SETNG**:624-631 is clearly insufficient, as the lexical links so far proposed are few and show irregular one-consonant correspondences.
Waia	Waia	**hv:Reesink:Aramia**	**hv:Wurm:Trans-Fly**:325 claims that Waia is related to the Pahoturi languages but adduces no evidence and there is certainly nothing obvious that links the two. Pronouns were not explicitly examined (and perhaps not implicitly either) by Ross **hv:Ross:Pronouns** but, in any case, they do not match Pahoturi.
North_Halmahera	North Halmahera	**hv:Voorhoeve:Masked**, **hv:Voorhoeve:NMoluccas**, **hvtyp:Klameretal:ENusantara**, **hv:Reesink:WPapuan**, **hv:Wada:NHalmahera**	
Boran	Boran	**s:FaguaSeifart:Ocaina**, **hv:SeifartEcheverri:Bora-Witotoan**, **hv:SeifartEcheverri:Bora-Witoto:2011**	**hv:Aschmann:Witotoan** clearly demonstrates the internal unity of Boran and Huitotoan respectively, on the grounds of shared basic lexicon (including pronouns). The Boran to Huitotoan comparisons, however, show irregular correspondences **s:FaguaSeifart:Ocaina**, **hv:SeifartEcheverri:Bora-Witotoan** and are therefore premature.
Comecrudan	Comecrudan	**hv:Campbell:Coahuiltecan**	
Sape	Sapé	**h:Mosonyi:Venezuela**	
Baining	Baining	**hv:Stebbins:EBismarcks** **hvld:Ross:EPapuan**:311	
Kuliak	Kuliak	**hv:Heine:Kuliak**	
Zamucoan	Zamucoan	**hv:Adelaar:Andes**, **hv:Ciucci:Zamucoan**, **hv:Bertinetto:Zamuco**	
Muskogean	Muskogean	**hv:Booker:Muskogean**, **hv:Martin-Munro:Proto-Muskogean**	
Mawes	Mawes	**v:Hammarstrom:Mawes**	
Zuni	Zuni	**hv:Campbell:1997**	
Tor-Orya	Tor-Orya	**hvld:Voorhoeve:CWTNG**, **hv:Ross:Pronouns**	The pronouns for Tor are not Trans New Guinea and other arguments have not been offered **hvld:Voorhoeve:CWTNG**:413-414, nor are there any apparent relations in newer data published after Voorhoeve. Tor and Orya are unquestionably related **phon:Fields:Orya**, **hw:SmitsVoorhoeve:Anceaux:B:I**.
Ongota	Ongota	**ev:SavaThubauville:Ongota**:227-234	
Ticuna-Yuri	Ticuna-Yuri	**hv:deCarvalho:Tikuna-Yuri**, **hvw:GoulardRodriguez:Yuri-Tikuna**	
Yawa	Yawa	**h:Foley:2000**, **hv:Jones:Yawa**	
Tekiraka	Tekiráka (Vacacocha, Awshiri)	**hv:Adelaar:Andes**	
Berta	Berta	**w:Andersen:Berta**, **s:TriulziDafallahBender:Berta**	
South_Bird's_Head_Family	South Bird's Head Family	**hvtyp:BerryBerry:SBH** **hvld:Voorhoeve:CWTNG**:437-446	Evidence for inclusion in Trans New Guinea is weak **hvld:Voorhoeve:CWTNG**:437-446, especially lexically. The same can be said for a relation with Inanwatan, Konda-Yahadian and the older West Papuan affiliation **hvtyp:BerryBerry:SBH**.
Oyster_Bay	Oyster Bay	**hv:Bowern:Tasmanian**	
Greater_Kwerba	Greater Kwerba	**h:ClouseDonohueMa:NCoast**	Including Isirawa, Airoran and Samarokena **h:ClouseDonohueMa:NCoast**:18-20
Yana	Yana	**hv:Campbell:1997**	
Kartvelian	Kartvelian	**hv:Boeder:Kartvelian**	
North-Eastern_Tasmanian	North-Eastern Tasmanian	**hv:Bowern:Tasmanian**	
Sepik	Sepik	**hv:Foley:Sepik-Ramu** **hv:Foley:Sepik:2013** **hvw:ConradDye:USepik**	Includes Abau, Yellow River, Iwam, Ram (Pouye, Karawa, Awtuw), Wogumusin-Chenapian, Tama, Kwoma-Kwanga (Kwoma, Kwanga, Mende), Sepik Hill for which the pronouns, gender markers as well as dative, locative marker and benefactive verb are largely cognate **hv:Foley:Sepik-Ramu**:126-139 and/or there are significant lexical relations **hvw:ConradDye:USepik**:12-14. The Ndu languages do not show cognate pronouns or gender markers, and there is there is a detailed refutation of the evidence so far presented that Ndu is related to Kwoma-Kwanga (or the rest of Sepik) **g:Aikhenvald:Manambu**. Yerakai shares no significant lexical relations with any Sepik language **hvw:ConradDye:USepik**:14, except Ndu **hv:Laycock:Sepik**:23, but these are arguably loans from the adjacent Iatmul (as of intermarriage) **hvw:ConradDye:USepik**:14. No other argument for a Sepik affiliation in offered **hvld:LaycockZGraggen:Sepik-Ramu**:738 and Yerakai is not mentioned in Foley's re-consideration of the Sepik family **hv:Foley:Sepik-Ramu**. Similarly, there is no evidence that Biksi is Sepik since nothing significant was presented **hvld:LaycockZGraggen:Sepik-Ramu** and the lexical evidence does not warrant it **hvw:ConradDye:USepik**. The Bikaru-Bragge wordlist in **hvw:ConradLewis:USepik** presumably represents the Pikaru dialect of Bisorio (an Engan language) despite the divergence of the two, since the body part terms agree and the elicitation sessions were monolingual.
Tequistlatecan	Tequistlatecan	**hv:Campbell:1997**	
Eastern_Jebel	Eastern Jebel	**hvw:Bender:EJebel**	No conclusive, methodologically sound basis for assigning Eastern Jebel to Eastern Sudanic **hv:Bender:ESudanic** or to an alleged full or partial Nilo-Saharan has been presented **hv:Blench:Nilo-Saharan**, **hv:Bender:Nilo-Saharan:2000**, **hv:Boyeldieu:Nilo-Sahariennes**.
Tamaic	Tamaic	**hv:Edgar:Tama**, **hvw:Edgar:Tama:Lexicon**	No conclusive, methodologically sound basis for assigning Tama to Eastern Sudanic **hv:Bender:ESudanic** or to an alleged full or partial Nilo-Saharan has been presented **hv:Blench:Nilo-Saharan**, **hv:Bender:Nilo-Saharan:2000**, **hv:Boyeldieu:Nilo-Sahariennes**.
Nuclear-Macro-Je	Nuclear Macro-Jê	**hv:Jolkesky:Proto-Je** **hv:RibeirovanderVoort:Jabuti-Je** **g:Ribeiro:Karaja**:262-287 **hv:Rodrigues:Je:2002** **hv:Boswood:Aripaktsa** **hv:Seki:Krenak-Je:2002** **hv:Gudschinsky:Ofaie-Xavante** **hv:Davis:Macro-Je:1968**, **hv:Davis:Macro-Je**	Convincing published lexical evidence exist for the relatedness of Northern-Southern Je in a Je subgroup **hv:Jolkesky:Proto-Je**, Je-Jabuti **hv:RibeirovanderVoort:Jabuti-Je**, Je-Karaja **g:Ribeiro:Karaja**:268-287, Je-Rikbaktsa **hv:Boswood:Aripaktsa**, Ofaye **hv:Gudschinsky:Ofaie-Xavante**, Maxakalian-Je **hv:Davis:Macro-Je:1968**, **hv:Davis:Macro-Je**, Je-Aimore **hv:Seki:Krenak-Je:2002**. For Kamakanan and Puri-Coropo-Coroado the lexical parallels adduced by **hv:Loukotka:Kamakan** and **hvw:Loukotka:Coroado** remain to be corroborated using Kamakanan proto-forms **hvw:Silva:Kamaka** and Puri-Coropo-Coroado proto-forms **hvw:daNeto:Puri**. For Kariri, Bororoan and Chiquitano there is suggestive, but not conclusive grammatical evidence **g:Ribeiro:Karaja**:265 **hv:Rodrigues:Macro-Je** **v:Ribeiro:Kariri** (also shared by Carib and Tupi **hv:Rodrigues:Tupi-Karib-Je**) and little in the way of lexicon. For Fulniô, Guató and Otí there is insufficient evidence whatsoever **g:Ribeiro:Karaja**:262-287.
Koman	Koman	**hv:Bender:Koman**	No conclusive, methodologically sound basis for assigning Koman to an alleged full or partial Nilo-Saharan has been presented **hv:Blench:Nilo-Saharan**, **hv:Bender:Nilo-Saharan:2000**, **hv:Boyeldieu:Nilo-Sahariennes**. Evidence for including Gule with Koman **hv:Bender:Koman** is so far insufficient.
Mailuan	Mailuan	**hv:Dutton:SETNG**, **hv:Dutton:Mailu**	Evidence for Trans New Guinea membership **hv:Dutton:SETNG**:624-631 **hv:McElhanonVoorhoeve:TNG** or with other neighbouring families **hv:Dutton:SETNG**:624-631 is clearly insufficient, as the lexical links so far proposed are few and show irregular one-consonant correspondences.
Xukuru	Xukuru	**h:Fabre:2005**	
Mure	Mure	**h:Teza:Americane**, **hvw:deCrequiMontfortRivet:Capakura**	The text analysis of Mure by **hvw:deCrequiMontfortRivet:Capakura** is sound, but the parallels with Chapacuran are limited to a few words, while the rest it utterly different. Therefore, the near-identical Chapacuran words are likely to be loans, especially given that the Mure were missioned together with Chapacuran peoples. No other relation for the Mure data has been suggested or is apparent.
Mangarrayi-Maran	Mangarrayi-Maran	**hv:Merlan:Mangarrayi**, **hv:Evans:Australia**, **hv:Sharpe:Alawa**	Verb morphology evidence for a Gunwinyguan affiliation **hv:Alpheretal:Gunwinyguan** or an Arnhem family **hv:Green:Maningrida** is still inconclusive.
Leko	Leko	**typ:vandeKerke:Leko**	
Dibiyaso	Dibiyaso	**hv:Reesink:Aramia**, **hvw:Shaw:Bosavi**	Dibiyaso is often associated with its northern neighbour Bosavi through a small number of matching lexical items. **hv:Reesink:Aramia**:12 gives a number of lexical lookalikes between Dibiyaso and Kaluli. These contain a few fairly convincing comparisons where Dibiyasu \emph{p} corresponds to Kaluli \emph{f}. The items in question are common to the entire Bosavi Watershed group (not just Kaluli) but none are found in the Etoro-Bedamini group. This suggests, that we are dealing with loans between Dibiyaso and the Bosavi watershed group. Similarly, Turumsa and Dibiyaso are said to share as much as 19\% lexicostatistical similarity **el:Tupper:Turumsa**, but, looking at the items in question and the sociolinguistic situation, a loan scenario is preferable to a genealogical one.
Awin-Pa	Awin-Pa	**hvld:Voorhoeve:CWTNG**:389-391	
Atacame	Atacame	**hv:Adelaar:Andes**	
Busa	Busa (Odiai)	**hv:Laycock:Isolates**	
Koreanic	Koreanic	**hv:Vovin:Koreo-Japonica**	See **hv:Vovin:Altaic** for the latest critique of Altaic.
Mimi-Gaudefroy	Mimi-Gaudefroy	**hv:Starostin:Mimi**	
Nimboranic	Nimboranic	**h:Foley:2000**	
Daju	Daju	**hv:Thelwall:Daju**	No conclusive, methodologically sound basis for assigning Daju to Eastern Sudanic **hv:Bender:ESudanic** or to an alleged full or partial Nilo-Saharan has been presented **hv:Blench:Nilo-Saharan**, **hv:Bender:Nilo-Saharan:2000**, **hv:Boyeldieu:Nilo-Sahariennes**.
Vilela	Vilela	**hv:ViegasBarros:Lule-Vilela**	Vilela shares some cultural vocabulary with Lule **hv:ViegasBarros:Lule-Vilela**, but otherwise the two are clearly distinct **s:Maccioni:Lule**:li-lv.
Aikana	Aikanã	**hvw:vanderVoort:Kwaza**	
Betoi	Betoi	**hv:Adelaar:Andes**	
Tegem	Tegem	**hv:Schadeberg:Kordofanian**	Tegem systematically stands out from Narrow Talodi lexically, pronominally, in the noun class system and alleged sound correspondences are often irregular. The alleged noun class form/meaning correspondences to other Kordofanian groups, namely Rashad and Heiban, in **hv:Schadeberg:Kordofanian**, **hv:Schadeberg:Kordofanische** are not convincing as conclusively genetic; As to form, there is much eclectic selection as well as irregular correspondences, and as to meaning, the methodology of finding non-cognate shared class items is highly dubious. Chance resemblance has not been excluded. The lexical evidence for a Kordofanian unity is weak in the extreme **hv:Blench:Kordofanian**. It follows that the arguments presented for a Niger-Congo affiliation are not compelling either.
Left_May	Left May	**s:Arsjo:Ama**, **hvw:ConradDye:USepik**	From **hvw:ConradDye:USepik** we know that the family is internally coherent (with sound correspondences) and that there are no convincing external relations revealed in the lexicon.
Cotoname	Cotoname	**hv:Campbell:Coahuiltecan**	
Southern_Daly	Southern Daly	**hv:Green:Murrinh-Patha**, **hv:ReidGreen:Daly**	
Taulil-Butam	Taulil-Butam	**hv:AikhenvaldStebbins:PNG**:250 **hvld:Ross:EPapuan**:311 **sd:Futscher:Taulil**:17	
Tangkic	Tangkic	**hv:Evans:Tangkic**, **hv:Evans:Tangkic:2005**	Despite **hvw:Evans:Minkin**, the lexical evidence for a relation to Minkin shows no regular correspondences, and the case does not improve when considering proto-Tangkic rather than the modern Tangkic languages (p.c.~Erich Round 2013).
Sulka	Sulka	**s:Reesink:Sulka**	
Itonama	Itonama	**s:Crevels:Itonama**	
Karankawa	Karankawa	**hv:Campbell:1997**	
Lule	Lule	**s:Maccioni:Lule**	Lule shares some cultural vocabulary with Vilela **hv:ViegasBarros:Lule-Vilela**, but otherwise the two are clearly distinct **s:Maccioni:Lule**:li-lv.
South-Eastern_Tasmanian	South-Eastern Tasmanian	**hv:Bowern:Tasmanian**	
Iwaidjan_Proper	Iwaidjan Proper	**hv:Evans:Non-Pama-Nyungan**, **hv:Evans:Australia**	The evidence for including Marrku-Wurrugu in Iwaidjan is not sufficient as the similarities may well be due to borrowing in the case of Marrku **hv:Evans:Marrku** and the very poorly attested Wurrugu was included because of its lexical correspondences with Marrku rather than the rest of Iwaidjan **vw:Evans:Wurrugu**.
Burushaski	Burushaski	**g:Berger:Hunza**	
Maningrida	Maningrida	**hv:Evans:Non-Pama-Nyungan**, **hv:Green:Maningrida**	Membership is Burarra, Gurr-Goni, Na-kara and Ndjébbana. Evidence for inclusion in an Arnhem family is still inconclusive.
Jirajaran	Jirajaran	**hv:Adelaar:Andes**	
Kuot	Kuot	**g:Lindstrom:Kuot**	
Siuslaw	Siuslaw	**hv:Campbell:1997**	
Kresh-Aja	Kresh-Aja	**hvs:Santandrea:Kresh**, **hv:Boyeldieu:CSudanic**	Neither the Kresh group nor Aja have yet been shown to be a bona fide Central Sudanic language **hv:Boyeldieu:CSudanic**. The argument by Santandrea that Aja is a Banda-ised Kresh-family language is convincing **hvs:Santandrea:Kresh**.
Kol	Kol	**hvtyp:DunnReesinkTerrill:EPapuan**, **hv:Terrill:EPapuan**	
South_Bougainville	South Bougainville	**hv:Evans:SBougainville**	
Abun	Abun	**hvtyp:Klameretal:ENusantara**, **hv:Reesink:WPapuan**, **hv:BerryBerry:WPapuan**	
Chapacuran	Chapacuran	**g:Angenot-de-Lima:More**	The text analysis of Mure by **hvw:deCrequiMontfortRivet:Capakura** is sound, but the parallels with Chapacuran are limited to a few words, while the rest it utterly different. Therefore, the near-identical Chapacuran words are likely to be loans, especially given that the Mure were missioned together with Chapacuran peoples.
Mixe-Zoque	Mixe-Zoque	**hvphon:Wichmann:Mixe-Zoquean**, **hv:Rhodes:Mixe-Zoquean**	Also includes Ulterior Mixe, a newly discovered language **ld:Wichmann:Ulterior-Mixe**
Eskimo-Aleut	Eskimo-Aleut	**hv:Fortescue:Eskaleoutes**	
Abkhaz-Adyge	Abkhaz-Adyge	**hv:Hewitt:NWC**	
Jivaroan	Jivaroan	**hv:Adelaar:Andes**	
Tallan	Tallán	**hv:Cerron-Palomino:Peruana**	There are occasional lexical links to the Sechuran language **hv:Adelaar:Andes**:398-400, but the very limited data available is not compelling towards a genetic relationship.
Bororoan	Bororoan	**hvw:Camargos:Bororo**	
Touo	Touo	**hv:Terrill:CSolomon**, **hv:DunnTerrill:Central-Solomons**	
Aymaran	Aymaran	**hv:Adelaar:Andes**, **hv:Heggarty:Quechumara**	
Uralic	Uralic	**hv:Abondolo:Uralic** **hv:Aikio:Uralic-Yukaghir**	
Bilua	Bilua	**hv:Terrill:CSolomon**, **hv:DunnTerrill:Central-Solomons**	
Kayagaric	Kayagaric	**hvld:Voorhoeve:CWTNG**:366-369	
Misumalpan	Misumalpan	**hv:Pineda:Misumalpan**	Interesting links have been noted with Lencan **hv:Costenla:LencasMisumalpas**.
Ainu	Ainu	**hv:Vovin:Proto-Ainu:1993**	
Gule	Gule	**hv:Bender:Koman**	Evidence for including Gule with Koman **hv:Bender:Koman** is so far insufficient.
Kalapuyan	Kalapuyan	**h:Mithun:NAmerica**	
Mayan	Mayan	**hv:Campbell:1997**	
Uru-Chipaya	Uru-Chipaya	**hv:Cerron-Palomino:Proto-Uro**	
East_Strickland	East Strickland	**hvw:Shaw:Bosavi**	Evidence for Trans New Guinea membership **hvld:Wurm:ECTNG**:509-510 is insufficient and the lexicostatistical figures **hvw:Shaw:Bosavi** linking East Strickland to Bosavi are difficult to reproduce
Coosan	Coosan	**hv:Campbell:1997**	
Cayuse	Cayuse	**h:Mithun:NAmerica**	
Muniche	Muniche	**hv:Adelaar:Andes**	
Usku	Usku	**hb:Hammarstrom:Least**	
Tungusic	Tungusic	**hv:Vovin:Altaic**	See **hv:Vovin:Altaic** for the latest critique of Altaic.
Tai-Kadai	Tai-Kadai	**hv:Enfield:SEAsia**, **hv:Ostapirat:Proto-Kra**	Jiamao [jio] has recently been suggested as a language isolate with heavy Hlai overlay **hvwphon:Norquest:Proto-Hlai**. However, if the suggestion of massive borrowing from Hlai into Jiamao is in fact correct, so little residual vocabulary remains that it appears insufficient for positing a new language isolate. Therefore Jiamao is counted as a Hlai, and thus Tai-Kadai, language.
Biksi	Biksi	**hvw:ConradDye:USepik**, **hv:Foley:Sepik:2013**, **hb:Hammarstrom:Least**	Evidence for a Sepik affiliation is too scant, though data is very scant too. No convincing lexical relationship with Kimki **hwsoc:Kim:Yetfa**.
Kawesqar	Kawesqar	**hv:ViegasBarros:Patagonia**, **hv:Adelaar:Andes**	
Andoque	Andoque	**hv:GildeaPayne:Macro-Carib**	
Indo-European	Indo-European	**h:Fortson:IE**	Bharia [bha] is an IE language close to Bundeli **hvwld:Grierson:4**:640-645
Tonkawa	Tonkawa	**hv:Campbell:1997**	
Yuchi	Yuchi	**hv:Campbell:1997**	
Timucua	Timucua	**hv:Campbell:1997**	
Tuxa	Tuxá	**h:Fabre:2005**	
West_Bird's_Head	West Bird's Head	**hv:Reesink:Birds-Head**, **hv:BerryBerry:WPapuan**, **hv:Voorhoeve:NMoluccas**, **hv:Reesink:WPapuan**, **hv:Flassy:Toror**	
Palaihnihan	Palaihnihan	**hv:Campbell:1997**	
Tsimshian	Tsimshian	**hv:Campbell:1997**	
Laal	Laal	**g:Boyeldieu:Laal**	
Maybrat	Maybrat	**hvtyp:Klameretal:ENusantara**, **hv:Reesink:WPapuan**, **hv:BerryBerry:WPapuan**	
Mpur	Mpur	**hvtyp:Klameretal:ENusantara**, **hv:Reesink:WPapuan**	
Masep	Masep	**h:ClouseDonohueMa:NCoast**	
Sumerian	Sumerian	**g:Edzard:Sumerian**	
Moraori	Moraori	**hv:Wurm:Trans-Fly**	Wurm's arguments **hv:Wurm:Trans-Fly**:327-335 for a Trans-Fly assignment are not convincing as the only argument appears to be unreliable lexicostatistical calculations.
Nyimang	Nyimang	**hvs:Stevenson:Nuba**	No conclusive, methodologically sound basis for assigning Nyimang to Eastern Sudanic **hv:Bender:ESudanic** or to an alleged full or partial Nilo-Saharan has been presented **hv:Blench:Nilo-Saharan**, **hv:Bender:Nilo-Saharan:2000**, **hv:Boyeldieu:Nilo-Sahariennes**. More recent more narrow parallels are suggestive but not enough to be conclusive **hv:Rilly:Nara**.
Yamana	Yámana (Yahgan)	**hv:ViegasBarros:Patagonia**, **hv:Adelaar:Andes**	
Lakes_Plain	Lakes Plain	**hvw:Clouse:Lakes-Plain**	
Maku	Máku	**hv:Migliazza:Orinoco**	
Garrwan	Garrwan	**hv:Breen:WanyiGarrwa**, **hv:Belfrage:WanyiGarrwa**	Wanyi, Garrwa.
Yuat	Yuat	**hv:Foley:Sepik:2013**, **hv:Foley:Sepik-Ramu**, **hv:Laycock:Sepik**	The family is assumed on lexical similarities hinted at by Laycock. What little data on Yuat that was available to Foley in connection with his demonstration of the Lower Sepik-Ramu family, it was not sufficient for a genetic relationship with Lower Sepik-Ramu. Sufficient argumentation for a relation with the Mongol-Langam languages is wanting **hv:Laycock:Sepik**.
Hurro-Urartian	Hurro-Urartian	**s:Wilhelm:Hurrian**, **s:Wilhelm:Urartian**	
Kusunda	Kusunda	**g:Watters:Kusunda**	
Matanawi	Matanawí	**hw:Nimuendaju:Madeira**	
Geelvink_Bay	Geelvink Bay	**h:Jones:ECenderawasih**, **hvw:Voorhoeve:Irian**	
Ramanos	Ramanos	**w:PalauSaiz:Moxos**	The minuscule wordlist in **w:PalauSaiz:Moxos** shows no convincing resemblances to surrounding languages.
Tucanoan	Tucanoan	**hv:Chacon:Proto-Tukanoan**	
Urarina	Urarina	**g:Olawsky:Urarina**	
East_Bird's_Head	East Bird's Head	**hv:Reesink:Birds-Head**, **hv:Donohue:Reesink**	
Hruso-Aka	Hruso-Aka	**hvw:BlenchPost:Arunachal**	Hruso-Aka [hru] is clearly not a Miji dialect as held by **hv:Shafer:Hruso**. The shared lexicon is attributable to loans, and of what remains, there are insufficient Tibeto-Burman parallels for a Tibeto-Burman affiliation **hv:Padun:NAssam**, **hvw:BlenchPost:Arunachal** **hv:Anderson:West-Kameng**, **v:Anderson:Hruso**.
Haida	Haida	**hv:Gollaetal:NAmerica**	Interesting well-analysed parallels between Haida, Eyak-Athapaskan and Tlingit have surfaced recently **hv:Enrico:Na-Dene** but is not enough to conclude a genetic relationship.
Namla-Tofanma	Namla-Tofanma	**hb:Hammarstrom:Least**	
Takelma	Takelma	**h:Mithun:NAmerica**	
Huitotoan	Huitotoan	**s:FaguaSeifart:Ocaina**, **hv:SeifartEcheverri:Bora-Witotoan**, **hv:SeifartEcheverri:Bora-Witoto:2011**	**hv:Aschmann:Witotoan** clearly demonstrates the internal unity of Boran and Huitotoan respectively, on the grounds of shared basic lexicon (including pronouns). The Boran to Huitotoan comparisons, however, show irregular correspondences **s:FaguaSeifart:Ocaina**, **hv:SeifartEcheverri:Bora-Witotoan** and are therefore premature.
Quechuan	Quechuan	**hv:Adelaar:Andes**, **hv:Heggarty:Quechumara**	
Puri-Coropo-Coroado	Puri-Coropo-Coroado	**hvw:daNeto:Puri**	The lexical similarities to Jê adduced by Loukotka **hvw:Loukotka:Coroado** remain to be corroborated using Puri-Coropo-Coroado proto-forms **hvw:daNeto:Puri**.
Natchez	Natchez	**hv:Campbell:1997**	
Guato	Guató	**phon:Postigo:Guato**:65-70, **g:Ribeiro:Karaja**:263-264	
Arafundi	Arafundi	**h:Foley:2000**	
Dem	Dem	**hvw:Larson:Irian-Highlands**	The cognation judgments involving Dem in **hvw:Larson:Irian-Highlands** are overly optimistic in that a match is judged if at least one segment matches. This procedure yields inconsistent sound correspondences. The lexicostatistic argument for relatedness is the only one offered so far, and apart from probable borrowings, we cannot find any cognates in vocabulary or morphology.
Araucanian	Araucanian	**hv:Adelaar:Andes**	
Songhay	Songhay	**hv:Nicolai:Nilo-Saharienne**, **hv:Souag:Songhay**	The Nilo-Saharan affiliation à la Ehret or Bender is thoroughly dismantled by Nicolaï, and the Berber-like lexical stratum remains inconclusive.
Puinave	Puinavé	**g:Giron:Wansojot**:419-439 **v:Bolanos:Kakua-Puinave**	There are some lexical paralles with Nadahup and Kakua-Nukak  **g:Giron:Wansojot**:419-439 but these are hardly conclusive of a genetic relation **v:Bolanos:Kakua-Puinave**.
Hatam-Mansim	Hatam-Mansim	**hv:Reesink:Irian**, **s:Reesink:Mansim**	
Rashad	Rashad	**hv:Schadeberg:Kordofanian**	Rashad is held together lexically and pronominally **hvs:Stevenson:Nuba**:46-52. The noun class system cannot be shown conclusively to be original as there as no secure traces of a loss. The alleged noun class form/meaning correspondences to other Kordofanian groups, namely Talodi (with Tegem) and Heiban, in **hv:Schadeberg:Kordofanian**, **hv:Schadeberg:Kordofanische** are not convincing as conclusively genetic; As to form, there is much eclectic selection as well as irregular correspondences, and as to meaning, the methodology of finding non-cognate shared class items is highly dubious. Chance resemblance has not been excluded. The lexical evidence for a Kordofanian unity is weak in the extreme **hv:Blench:Kordofanian**. It follows that the arguments presented for a Niger-Congo affiliation are not compelling either.
Mande	Mande	**hv:Brauner:Mande**, **hvw:Vydrine:Mande**, **hv:Dwyer:Mande**, **hv:Dwyer:Mande-Niger-Congo**	Mande has not yet been shown to contain systematic sound correspondences, noun class systems or verbal extensions with Niger-Congo in some form.
Bayono-Awbono	Bayono-Awbono	**hvw:Wilbrink:Kopkaka**	
Khoe-Kwadi	Khoe-Kwadi	**hv:GuldemannElderkin:Khoe-Kwadi**, **hvphon:Vossen:Khoe** **hv:Guldemann:Khoisan:2014**	
Wagiman	Wagiman	**hv:Evans:Non-Pama-Nyungan**	So far there has been no published case for a relation with Yangmanic beyond typological similarities and very low cognate percentages **s:Wilson:Wagiman**:5-6, and there is no obvious relation between the two **g:Cook:Wagiman**.
Cariban	Cariban	**hv:Gildea:Cariban**, **hv:Meira:Cariban:2006**, **hv:GildeaPayne:Macro-Carib**	There is parallel in relational prefix with Tupian and (Macro-Je) which is suggestive but not conclusive **hv:Rodrigues:Tupi-Karib-Je**
Kaure-Narau	Kaure-Narau	**hvw:Voorhoeve:Irian**, **hb:Hammarstrom:Least**	A newer evaluation of the lexical relationships (claimed in **hvw:Voorhoeve:Irian**:45) show no signficant relationship between the Kaure-Narau languages and Kapauri (**wsoc:Rumaropen:Kapauri**):13.
Birri	Birri	**s:Santandrea:Birri**, **hv:Boyeldieu:CSudanic**	Birri has not yet been shown to be a bona fide Central Sudanic language **hv:Boyeldieu:CSudanic**.
Nyulnyulan	Nyulnyulan	**hv:Bowern:Nyulnyulan**, **hv:StokesMcGregor:Nyulnyulan**	
Guaicuruan	Guaicuruan	**hv:ViegasBarros:Guaicuru-Reconstruccion:2013**	
Mairasi	Mairasi	**hv:Peckham:Etna**	Links with Tanahmerah are unconvincing lexically and pronominally **hvld:Voorhoeve:CWTNG**:424-431 **hv:Ross:Pronouns**.
Yukaghir	Yukaghir	**hv:Nikolaeva:Yukaghir**	
Anim	Anim	**hv:UsherSuter:Anim**	Not including Inanwatan, though typological affinities have been noted **hv:deVries:Inanwatan**. Abom [aob] is included in the basis of lexicostatical similarities in the range 11-14\% **el:Tupper:Abom** and the gender forms of the verb pace the known caveats of lexicostatistics and transfer in endangered languages. The pronouns resemble the typical Trans New Guinea pattern and there are some parallels in the gender system to Ok, but this is not enough to conclude a Trans New Guinea affiliation for the Anim languages.
Suki-Gogodala	Suki-Gogodala	**hv:Foley:Papuan**, **hv:Voorhoeve:Suki-Gogodala**	
Sentanic	Sentanic	**hv:HartzlerGregerson:Proto-Tabla-Sentani**, **hv:Cowan:Austronesisch-Papoease**	The relation of Sentani-Nafri-Tabla (SNT) to Demta is best argued in **hv:Cowan:Austronesisch-Papoease**:161-163, see also **hv:Cowan:Papuan**, and can be verified with the subsequent SNT phonological reconstruction **hv:HartzlerGregerson:Proto-Tabla-Sentani** and the longer wordlists in **hw:SmitsVoorhoeve:Anceaux:B:I**.
West_Bomberai	West Bomberai	**hvld:Voorhoeve:CWTNG**:432-437	The inclusion of the poorly known Karas is best argued in **hvw:Cowan:Ambtelijk**:33-36, with systematic correspondences in pronominals and a few items of basic vocabulary. Evidence for inclusion in Trans New Guinea is weak **hvld:Voorhoeve:CWTNG**:432-437, both lexically and pronominally, cf.~**hv:Pawley:Chequered-TNG**:94-95. Likewise, the East Timor/Alor comparisons in **hv:Hull:Timor** are flimsy.
Guamo	Guamo	**hv:Adelaar:Andes**	
Atakapa	Atakapa	**hv:Martin:Southeastern**	
Jodi-Saliban	Jodi-Saliban	**v:Rose:Jodi-Saliban**	
Eastern_Trans-Fly	Eastern Trans-Fly	**hv:Wurm:Trans-Fly** **hwsoc:FleischmannTurpeinen:ETrans-Fly**	Wurm's arguments **hv:Wurm:Trans-Fly**:327-335 for a Trans New Guinea affiliation appear to be unreliable lexicostatistics and typological features. Likewise, the lexical and pronominal evidence for a Trans New Guinea affiliation is weak. See **hwsoc:FleischmannTurpeinen:ETrans-Fly** for additional lexical data on the internal coherence of the group.
Bogaya	Bogaya	**hvld:Voorhoeve:CWTNG**:395-396	Arguments for the relatedness for Duna and Bogaya are given in **hvld:Voorhoeve:CWTNG**:395-396 but pronouns do not match sufficiently well for an immediate Trans New Guinea affiliation, and apart from this, there are only capricious lexical similarities to other families **hvs:Shaw:MtBosavi**.
Chimakuan	Chimakuan	**hv:Campbell:1997**	Incl. Quileute
Pankararu	Pankararu	**h:Fabre:2005**	
Seri	Seri	**hv:Marlett:Hokan**	
Gaagudju	Gaagudju	**hv:Evans:Non-Pama-Nyungan**, **hv:Evans:Australia**	Evidence for an Arnhem family or a Gunwinyguan affiliation is not sufficient.
Coahuilteco	Coahuilteco	**hv:Campbell:Coahuiltecan**	
Bogia	Bogia	**hv:Laycock:Torricelli** **hvld:Zgraggen:Madang**:180-183	No evidence for the Bogia (Monumbo) languages being related to other Torricelli languages was ever presented **hv:Laycock:Torricelli**.
Washo	Washo	**hv:Campbell:1997**	
Cuitlatec	Cuitlatec	**hv:Campbell:1997**	
Yangmanic	Yangmanic	**hv:Evans:Non-Pama-Nyungan**	So far there has been no published case for a relation with Wagiman beyond typological similarities and very low cognate percentages **s:Wilson:Wagiman**:5-6, and there is no obvious relation between the two **g:Cook:Wagiman**.
Nilotic	Nilotic	**h:Dimmendaal:Nilotic**, **hv:Dimmendaal:Nilotic**	No conclusive, methodologically sound basis for assigning Nilotic to Eastern Sudanic **hv:Bender:ESudanic** or to an alleged full or partial Nilo-Saharan has been presented **hv:Blench:Nilo-Saharan**, **hv:Bender:Nilo-Saharan:2000**, **hv:Boyeldieu:Nilo-Sahariennes**.
Baibai-Fas	Baibai-Fas	**hvs:Baron:Kwomtari**	Laycock never presented real evidence for a Kwomtari-Baibai-Pyu family **hv:Laycock:SkoKwomtariLeftMay**. The membership is Baibai [bbf] and Fas [fqs] and not Biaka/Nai [bio] as many sources have erroneously repeated.
