blv	blv	**hw:Koelle:Polyglotta**
nwr	nwr	**hw:Ray:ESEPapua**
Bainounk	Bainounk	**styp:Cobbinah:Bainounk-Gubeeher**:31-34
Warekena-Mandahuaca	Warekena-Mandahuaca	**hvw:Ramirez:Arawak**:329-349
Manding	Manding	**hv:Galtier:Mandingues**
Mainland North Halmaheran	Mainland North Halmaheran	**hv:GrimesGrimes:NMoluccas**:51-54
Chutic	Chutic	**hv:Sidwell:Austroasiatic:2015**:205
Western Shinaic	Western Shinaic	**hv:Liljegren:Dangari**
mws	mws	**hv:Hinnebusch:Contact-Lexicostatistics**
mwp	mwp	**hv:Alpheretal:WTorres** **hv:BowernAtkinson:Pama-Nyungan**:833-834
aue	aue	**hv:HeineHonken:Kxa**
Northwestern Mande	Northwestern Mande	**hvtyp:Kastenholz:Samogo**:100 **hv:Kastenholz:West-Mande**
Huavean	Huavean	**g:Kim:Huave**:3 **hvw:Suarez:Huaves**
mwz	mwz	**he:Moeller:Orientale-Congo**
auj	auj	**hv:Kossmann:Proto-Berbere**:31 **hv:Kossmann:Arabic-Berber**:25
Mijikenda	Mijikenda	**hv:NursePhilippson:EAfrica**
mwa	mwa	**hvsoc:Lithgow:Fergusson-Normanby** **hvld:Lithgow:Milne**
aur	aur	**hv:Laycock:Sepik**:14
aut	aut	**hvld:Fischer:Austral**
aux	aux	**v:Mello:Aure-Aura**
Central Ngayarda	Central Ngayarda	**hv:BowernAtkinson:Pama-Nyungan**
Ewondo-Bebele	Ewondo-Bebele	**hvw:Wega:Polri**
Iranian	Iranian	**hv:Schmitt:Iranischen**
Northern Pama	Northern Pama	**hv:Hale:Paman**
cwa	cwa	**h:Tanzania:Tanzania**:xi
Bandjalangic	Bandjalangic	**hvw:Jefferies:Guwar**
Maiduan	Maiduan	**hvb:Golla:California**
Worrorran	Worrorran	**hv:McGregorRumsey:Worrorran**
Athapaskan	Athapaskan	**hv:Campbell:1997**
Seuta	Seuta	**hv:NursePhilippson:EAfrica**
Sena-Nyanja	Sena-Nyanja	**hv:Bastinetal:Bantu**:220
cml	cml	**hvw:GrimesGrimes:South-Sulawesi**:30-32
Daic	Daic	**hvld:Luo:Zhuang** **hv:Pittayaporn:Proto-Tai** **hv:EdmondsonSolnit:Kadai-Tai:Introduction**
Nungish	Nungish	**hv:Matisoff:Jingpho**:3-6 **hv:Bradley:Tibeto-Burman:1997**:32-35 **hv:Bradley:Tibeto-Burman**:93-94
Sere-Ngbaka-Mba	Sere-Ngbaka-Mba	**h:BoydPasch:Sere-Ngbaka-Mba**
cms	cms	**hv:Clackson:Indo-European**:7 **ld:deSimoneMarchesini:Messapicae**
cmr	cmr	**hvw:Hartmann:Southern-Chin**
Arandic	Arandic	**hv:Koch:Arandic**
Kazhou-Samu	Kazhou-Samu	**hvw:Lama:Nisoic**:157
Eastern Farsic	Eastern Farsic	**h:Kieffer:Afghanistan**
North Mozambique Bantu	North Mozambique Bantu	**hv:Nurse:EBantu**
Himalayish	Himalayish	**hv:vanDriem:Himalayas**
Hani-Jino	Hani-Jino	**hvw:Lama:Nisoic**
Greater Maric	Greater Maric	**hv:Sutton:Gugu-Badhun**
NOCODE_Old-Telugu	NOCODE_Old-Telugu	**s:Ramanarasimham:OldTelugu**:181
Khmuic	Khmuic	**hv:Sidwell:Khmuic**
Algic	Algic	**hvb:Golla:California**
ned	ned	p.c. Roger Blench 2011
Biak-Roon	Biak-Roon	**hvw:Anceaux:Yapen**:146
nea	nea	**w:DjawanaiGrimes:Ngada**
Natugu-Nalogo	Natugu-Nalogo	**hv:Lincoln:Reef-Santa** **hv:Wurm:EPapuan**
Kunar	Kunar	**hvld:Bashir:Dardic**
kuk	kuk	**he:Verheijen:Manggarai**:16-21
nes	nes	**hv:SaxenaBorin:West-Himalayish**
mef	mef	**h:Burling:Modhupur-Mandi**
Mwika	Mwika	**hv:Labroussi:Sud-Ouest-Tanzania**
NOCODE_Lwel	NOCODE_Lwel	**hv:KoniBostoen:Kwilu**
meo	meo	**hb:Collins:Malay-Malaysia**
nmq	nmq	**phon:Kadenge:Nambya**
ors	ors	**he:Carey:Orang-Asli**:279
mew	mew	**w:Newman:Maha**
mes	mes	**hwsoc:Martietal:Kajakse**
Isle-de-France Creole	Isle-de-France Creole	**g:BakerCorne:IsledeFrance**
dry	dry	**g:Dhakal:Darai**:166-167
Western Mande	Western Mande	**hv:Kastenholz:West-Mande** **hv:Dwyer:Mande:1989**
drq	drq	**hv:vanDriem:Himalayas**
Ho-Mundari	Ho-Mundari	**d:Hoffmann:Mundarica**
drw	drw	**wsoc:BeckBeyer:Darwazi**
Galician Romance	Galician Romance	**hv:Agard:Romance**:116-123
sjl	sjl	**vw:Blench:Miji** **hvw:BlenchPost:Arunachal** **hv:Anderson:West-Kameng** **hv:Anderson:West-Kameng**
drn	drn	**v:vanEngelenhoven:West-Damar**
Ataitan	Ataitan	**hvld:Zgraggen:Madang**:149-151
drc	drc	**ldsoc:EndruschatFerreira:Minderico**
drg	drg	**ld:King:Rungus**
Kolopom	Kolopom	**s:Drabbe:Frederik** **hsoc:MenantiSusanto:Kimaam**
txj	txj	**ld:Bondarev:Old-Kanembu**
Maya-Matbat	Maya-Matbat	**hv:Kamholz:South-Halmahera-West-New-Guinea**:137
brw	brw	**hvld:Andronov:Dravidian**
brl	brl	**hld:AnderssonJanson:Botswana**:41-42 **hv:Batibo:Bantu-Botswana**:25
Malayic	Malayic	**hv:Ross:Malayic**
Lemerig-Veraa	Lemerig-Veraa	**hv:KalyanFrancois:Freeing**
Okani (B.30)	Okani (B.30)	**hv:vanderVeen:B30**
North and Central Vanuatu	North and Central Vanuatu	**h:Tryon:Espiritu-Santo** **hv:Clark:North-Central-Vanuatu**
lwu	lwu	**vphon:Yang:Lawu**
lwm	lwm	**ldsoc:Xu:Laomian**:99-100
lwa	lwa	**v:Meeussen:Mbagani-Lwalwa**
Leinong-Makyan	Leinong-Makyan	**hvsoc:Wayeshaetal:Lahe**
nka	nka	**hv:Bastinetal:Bantu**:219
nkb	nkb	**hb:Matisoff:Tibeto-Burman**
Ramu	Ramu	**hv:Foley:Sepik:2013**
nkn	nkn	**g:Fleisch:Lucazi**:13
nkp	nkp	**hv:Biggs:Polynesian**
jml	jml	**ld:Sijapati:Jumli**
nkw	nkw	**s:Mangulu:Lonkutsu**
Californian Uto-Aztecan	Californian Uto-Aztecan	**hv:Hill:Uto-Aztecan** **hvb:Golla:California**
Lezgic	Lezgic	**hv:Kassian:Lezginskix**
tnu	tnu	**he:Schliesinger:Austro-Thai**
tnv	tnv	**h:Bernot:Chittagong**
xhe	xhe	**w:Morgenstierne:Khetrani** **hvw:Grierson:8:I**
Minahasan	Minahasan	**hv:Sneddon:Proto-Minahasan**
Nuclear Goroka	Nuclear Goroka	**hvw:Scott:East-Central**:163-197
era	era	**he:Thurston:SIndia:2** **h:Reddy:South-Indian**
Victorian Pama-Nyungan	Victorian Pama-Nyungan	**hv:BowernAtkinson:Pama-Nyungan**
tni	tni	**hv:Kamholz:South-Halmahera-West-New-Guinea**:140
West Chadic A.1	West Chadic A.1	**hv:Newman:Chadic:1977**
West Chadic A.3	West Chadic A.3	**hv:Takacs:Angas-Sura**
West Chadic A.4	West Chadic A.4	**hv:Newman:Chadic:1977**
Mandaraic	Mandaraic	**hv:Gravina:Central-Chadic**:51-53
Western Nilotic	Western Nilotic	**hvtyp:Storch:WNilotic**
Southern Uto-Aztecan	Southern Uto-Aztecan	**hv:Merrill:Southern-Uto-Aztecan** **hv:Hill:Uto-Aztecan**
Mountain Ok	Mountain Ok	**hvw:Healey:Ok**
Kalamian	Kalamian	**hv:Himes:Kalamian**
Hunter-Hastings	Hunter-Hastings	**hvw:Waferetal:New-South-Wales**
end	end	**phon:McDonnell:Ende**
Bihari	Bihari	**hv:Jeffers:Bihari**
eno	eno	**v:Edwards:Enggano**
Zaparoan	Zaparoan	**hv:deCarvalho:Zaparoan**
NOCODE_Old-Malay	NOCODE_Old-Malay	**s:Mahdi:OldMalay**
hor	hor	**hw:Gaudefroy-Demombynes:Oubangui-Chari**
Southwest Coastal Malekula	Southwest Coastal Malekula	**g:Dimock:Nahavaq**:5
South Tanimbar	South Tanimbar	**hv:Hughes:Kei-Tanimbar-Aru** **hv:Collins:Maluku**
Chuwaboic	Chuwaboic	**wsoc:Reiman:Lolo**
hoy	hoy	**hvwld:Grierson:4**
Dusunic	Dusunic	**hv:Smith:Sabah**:26-40 **hdialsoc:BankerBanker:Kadazan-Dusun**
lak	lak	**hv:Elders:Kebi-Benue**
Irula-Muduga	Irula-Muduga	**lde:Zvelebil:Irulas**:107 **v:Subrahmanyam:Irula**
laz	laz	**s:Holzknecht:Aribwatsa**
Sardo-Corsican	Sardo-Corsican	**s:Jones:Sardinian** **hv:Agard:Romance**:61-73
Algonquian	Algonquian	**hv:Campbell:1997**
Tsamosan	Tsamosan	**hv:Czaykowska-HigginsKinkade:Salish**
Adamawa Bua	Adamawa Bua	**hv:Boyeldieu:Boua**
Giimbiyu	Giimbiyu	**s:Campbell:Urningangk**
Comorian Bantu	Comorian Bantu	**hvw:Full:Komorischen**
Sinitic	Sinitic	**hvtyp:Yue:Chinese**
Charruan	Charr√∫an	**w:Lafone:Chanases**
Nage-Keo	Nage-Keo	**g:Baird:Keo**
Tivoid	Tivoid	**hvw:Blench:Tivoid**
Kordofan Nubian	Kordofan Nubian	**typ:ComfortJakobi:Uncunwee**:27
Matumbic	Matumbic	**hv:Nurse:SWTanzania**:93
NOCODE_Nam	NOCODE_Nam	**hv:vanDriem:Himalayas**
wud	wud	**hv:Kluge:Gbe:2006**
Makaaic	Makaaic	**hv:Cheucle:Makaa-Njem**:516
wuh	wuh	**s:Janhunenetal:Wutun**:11-12
ima	ima	**he:Singh:Scheduled**:702
fit	fit	**g:PohjanenMuli:Meankieli**
Brahmaputran	Brahmaputran	**hv:vanDriem:Himalayas** **hv:Matisoff:Jingpho**:3, 41-42
Dagan	Dagan	**hv:Dutton:SEPapua**:15-19
Maewo	Maewo	**hvb:LynchCrowley:Vanuatu**
Kela-Ntomba	Kela-Ntomba	**hv:Bastinetal:Bantu**:205-206
imy	imy	**w:Sherevoshkin:Milyan**
Banda	Banda	**hvw:Olson:Banda**
Ukrainian-Rusyn	Ukrainian-Rusyn	**g:Pugh:Rusyn**:1-9
Yaka-Suku	Yaka-Suku	**v:BostoenKoni:Hungan**
NOCODE_Wayumara	NOCODE_Wayumara	**hv:Girard:Carib**
Agi-Yeri	Agi-Yeri	**hvw:Laycock:Lumi**:48 and p.c.~Jennifer Wilson
mxj	mxj	**hld:Sun:Eastern-Himalayan-China** **hvw:BlenchPost:Arunachal**
Lobiri-Jaane	Lobiri-Jaane	**v:Miehe:Lobiri-Jaane**
mxg	mxg	**hw:ChatelainSummer:Lange-Songe-Mbangala-Kioko-Lunda**
Shona (S.10)	Shona (S.10)	**hv:EhretKinsman:SAfrica**
Kirma-Tyurama	Kirma-Tyurama	**v:Miehe:Cerma-Curama**
Turkic	Turkic	**hv:Johanson:Turkic:2006** **hv:Johanson:Turkic:2006** **sv:Pakendorf:Sakha**:4-7
Goilalan	Goilalan	**hv:Dutton:SETNG**:631-632 **hv:HooleyMcElhanon:Morobe**:1076
Celebic	Celebic	**hv:Mead:Celebic**
Chaga	Chaga	**hv:Winter:Kilimanjaro-Bantu** **hv:Nurse:ChagaTaita**
Mongolic	Mongolic	**hv:Rybatzki:Mongolic**
Numic	Numic	**hv:Garrettetal:Numic**
xga	xga	**hvld:EskaEvans:Continental-Celtic**
Central Maluku	Central Maluku	**hvw:Collins:CMaluku**
Dhivehi-Sinhala	Dhivehi-Sinhala	**g:Cain:Dhivehi**
Tusia	Tusia	**typ:Winkelmann:Win**
ajz	ajz	**hv:vanDriem:Himalayas**:583
Chitral	Chitral	**hvld:Bashir:Dardic**
Uruwa	Uruwa	**g:McElhanon:Selepet-Finisterre-Huon**:44
goe	goe	**hv:vanDriem:Himalayas** **hvld:vanDriem:Black-Mountain**
Northern Uto-Aztecan	Northern Uto-Aztecan	**hv:Hill:Uto-Aztecan**
smt	smt	**hv:Bradley:Tibeto-Burman**:90
wss	wss	**h:DolphyneDakubu:Volta-Comoe**
Saami	Saami	**hv:Sammallahti:Saami**:6-38
Batuley-Mariri	Batuley-Mariri	**g:Daigle:Batuley**:1-2
smm	smm	**h:SkarGurung:Tharus** **h:Guneratne:Tharu**
Ok-Oksapmin	Ok-Oksapmin	**hv:LoughnaneFedden:Oksapmin-Ok**
Ifugaw	Ifugaw	**hw:Walrod:Dialect-Ifugao**
smd	smd	**e:Heintze:Kisama**
goq	goq	**h:Taber:Maluku**:126
nty	nty	**hld:Edmondson:3Tibeto-Burman**
North Bougainville Oceanic	North Bougainville Oceanic	**hv:Ross:WMelanesia**:215-256
Kanuri-Kanembu	Kanuri-Kanembu	**w:Lohretal:Kanuri**
Kiowa-Tanoan	Kiowa-Tanoan	**hvbtyp:Sutton:Kiowa-Tanoan**:1173-1191
Nadahup	Nadahup	**g:Epps:Hup**:3-5
Left_May	Left May	**hvw:ConradDye:USepik**
Chibchan	Chibchan	**hv:Constenla-Umana:Chibchan**
yia	yia	**s:Dench:Yingkarta**:9-12
Yimin-Bel	Yimin-Bel	**hsoc:Hutchinson:Heyoetc**:126
Beromic	Beromic	**hv:Blench:Prospecting**
uky	uky	**w:Hall:Kuk-Yak**
NOCODE_Bafoto	NOCODE_Bafoto	**s:Hulstaert:Bafoto**
atm	atm	p.c.~Jason Lobel 2012
atk	atk	**hv:Blust:CPhilippines**:80
Lower Mamberamo	Lower Mamberamo	**h:Jones:ECenderawasih** **s:Donohue:Warembori** **w:LeRoux:Woordenlijsten**
Kwalean	Kwalean	**hv:Dutton:SETNG**:636
Nyanga-Mituku-Lega	Nyanga-Mituku-Lega	**hv:Bastinetal:Bantu**:209-210 **hvb:vanBulck:Congo**:228-235xs
Oti-Volta Oriental	Oti-Volta Oriental	**hv:Sambieni:Proto-Oti-Volta-Oriental**
Pashayi	Pashayi	**hvld:Bashir:Dardic**
isa	isa	**hv:Pawley:Chequered-TNG**:93 **hv:Ross:Voorhoeve**:146
kfw	kfw	**h:Grierson:Chote-Muntuk-Karum**
nhg	nhg	**g:Tuggy:Tetelcingo**
nhf	nhf	**hv:OGrady:Proto-Ngayarda**
kfr	kfr	**lde:Schaad:Cutchi-Kenya**
kfs	kfs	**hs:Bailey:Himalaya**
nhc	nhc	**phonw:Garcia:Jalupa-Tabasco** **hvw:Lastra:Nahuatl-Moderno**
North New Guinea linkage	North New Guinea linkage	**hv:Ross:WMelanesia**:120-132
nhh	nhh	**hvw:Grierson:7**
nht	nht	**hvw:Lastra:Nahuatl-Moderno**
nhq	nhq	**hvw:Lastra:Nahuatl-Moderno**
Luric	Luric	**hvw:Anonby:Luri**
kfl	kfl	**h:Good:Fungom**
Albanian-Tosk	Albanian-Tosk	**hv:Sasse:Albanischen**
nhy	nhy	**hvw:Lastra:Nahuatl-Moderno**
kfh	kfh	**hb:RamaiahReddy:Tribal-Dravidian**
nhz	nhz	**hvw:Lastra:Nahuatl-Moderno**
toz	toz	**hv:Elders:Kebi-Benue**
Kesawai-Sausi	Kesawai-Sausi	**hb:Zgraggen:Madang**:13
Eastern Admiralty Islands	Eastern Admiralty Islands	**hv:Ross:WMelanesia**:315-345
Budja (C.36)	Budja (C.36)	**s:Mangulu:Buja** **hv:HackettvanBulck:ETeam**:77
Yolmo-Kagate	Yolmo-Kagate	**hv:Gawne:Yolmo-Kagate**
Ta-Ne-Omotic	Ta-Ne-Omotic	**hv:Bender:Omotic**
Markham	Markham	**hvphon:Holzknecht:Markham**
NOCODE_Tangam	NOCODE_Tangam	**ld:Post:Tangam**:9-10  **hv:Post:Defoliating-Tani**
Defoid	Defoid	**hv:Ohiri-Aniche:Akoko**
ukh	ukh	**v:Thornell:Ukhwejo**
gyi	gyi	**s:Renaud:Bajele**
Shastan	Shastan	**hvb:Golla:California**
Kiwaian	Kiwaian	**hvld:Wurm:Kiwaian**
Coastal Tor	Coastal Tor	**hwsoc:LeeWambaliau:Kwanem**
Angan	Angan	**hvphon:Lloyd:Angan**:36
Norman Pama	Norman Pama	**hv:Black:Norman-Pama**
ktr	ktr	**h:Kroeger:Dusunic**
ktl	ktl	**h:Windfuhr:New-Iranian**:248
NOCODE_Bapen	NOCODE_Bapen	**w:SantosFerry:Wey-Pe**:82 **vld:Ferry:Bapen**:353-354
ktd	ktd	**s:Platt:Gugada**:1
ktf	ktf	**h:Biebuyck:Lega**
kta	kta	**hv:Sidwell:Cua-EBahnaric**
ktc	ktc	**hld:JungraithmayrLeger:Bole-Tangale**
Phay-Mal-Tin	Phay-Mal-Tin	**hv:Filbeck:Tin** **hv:Rischel:Mlabri-Mon-Khmer**
lbu	lbu	**hv:Holzknecht:Labu**
ral	ral	**hvw:Grierson:3:III**
Paresi-Saraveka-Saluma	Paresi-Saraveka-Saluma	**hv:Danielsen:Baure-Personal**
Waka-Kabic	Waka-Kabic	**hvwphon:Holmer:South-Eastern-Queensland**
Bisaya-Lotud	Bisaya-Lotud	**hv:Lobel:Southwest-Sabah**
Blue_Nile_Mao	Blue Nile Mao	**hv:Fleming:Mao:2007**
lbm	lbm	**s:Dasgupta:Lodha**:152-153
ray	ray	**v:Walworth:Old-Rapa**
Egyptian	Egyptian	**hv:Satzinger:Egyptian**
Balkan Romance	Balkan Romance	**hv:Rosetti:Romane**
Muna-Buton	Muna-Buton	**hv:vandenBerg:Muna-Buton:2003** **hv:Donohue:Muna-Buton**
Mnong	Mnong	**hv:Blood:Mnong**
vgr	vgr	**hsoc:Rahman:Pakistan**
Trans-Zab	Trans-Zab	**hv:Mutzafi:Trans-Zab**
East_Strickland	East Strickland	**hvw:Shaw:Bosavi** **e:Dwyeretal:Kubo-Febi-Konai**
thi	thi	**hv:Edmondson:Shan**
tyj	tyj	**phon:Ferlus:Tai-Nghe-An**
Crimean Tatar-Urum	Crimean Tatar-Urum	**s:Podolsky:Urum**
tya	tya	**hv:Pawley:Proto-Trans-New-Guinea-Obstruents**
Mangbetu-Asua	Mangbetu-Asua	**phon:Demolin:Mangbetu**
Burmo-Qiangic	Burmo-Qiangic	**hv:JacquesMichaud:Naxi-Na-Laze**
tyt	tyt	**phon:DonaldsonEdmondson:Tay-Tac**
Khandesic	Khandesic	**hvwt:Grierson:9:III**
Koongo-Kituba	Koongo-Kituba	**s:Mufwene:Kituba**
Timor-Alor-Pantar	Timor-Alor-Pantar	**hv:Schapperetal:Timor-Kisar-Alor-Pantar**
Sindhi-Lahnda	Sindhi-Lahnda	**hv:Masica:Indo-Aryan**
Andic	Andic	**hv:Gudava:Andijskix**
Manambu-Yalaku	Manambu-Yalaku	**typ:Aikhenvald:Yalaku**:242-243
Igboid	Igboid	**hv:Williamson:Igboid**
abg	abg	Pace **el:Tupper:Abaga** and **hvld:McElhanon:NETNG**:543 lower numerals **hld:Lean:EHighlands**:27-29 and other items of basic vocabulary look similar to their Eastern Highlands counterparts especially with in the Kamano-Yagaria group
Koyo-Mboshi	Koyo-Mboshi	**hv:Bastinetal:Bantu**:205 **hphontyp:NdingaOba:Congo-Brazzaville**
Arakanese-Marma	Arakanese-Marma	**phon:Bradley:Arakanese**
West Germanic	West Germanic	**hv:Stiles:West-Germanic** **hv:Harbert:Germanic**
doy	doy	**hv:Blench:Dompo**
NOCODE_Jova	NOCODE_Jova	**hv:Miller:Uto-Aztecan:1983**:122 **hbld:Shaul:Opatan**:224
Bodic	Bodic	**hv:vanDriem:Himalayas**
pkr	pkr	**hsoc:Mathew:Wayanad**
Cushitic	Cushitic	**hv:Tosco:Cushitic** **hv:Kiessling:South-East-Cushitic**
Leseic	Leseic	**g:Vorbichler:Balese**:1-13
Surmic	Surmic	**hv:Yigezu:Surmic**
Western Iranian	Western Iranian	**hv:Schmitt:Iranischen**
Chonan	Chonan	**hv:ViegasBarros:Patagonia**:47-68
Jala	Jala	**hv:Baker:Gunwinyguan**
Greater Luyana	Greater Luyana	**hv:Lisimba:Luyana**
Arawan	Araw√°n	**hv:Dienst:Arawan**
Dutch Caribbean Creole	Dutch Caribbean Creole	**vw:Robertson:Berbice-Skepi**
Phunoi-Coong	Phunoi-Coong	**hld:Edmondson:Central-Southern-Loloish**
Trukic	Trukic	**hvw:Jackson:Trukic**
NOCODE_Rengmitca	NOCODE_Rengmitca	**vtyp:Peterson:Rengmitca**
Musguic	Musguic	**hv:Gravina:Central-Chadic**:60 **hv:Tourneux:Musgu**
Gresi-Kemtuik	Gresi-Kemtuik	**hv:Fautngil:Grime** **g:Anceaux:Nimboran**:2
Nabak-Momolili	Nabak-Momolili	**hv:HooleyMcElhanon:Morobe**:1071
Nabi-Irarutu	Nabi-Irarutu	**g:Jackson:Irarutu**:11-12, 325-420
kub	kub	**hvtyp:Prischnegg:Yukuben** **hvw:Shimizu:Jukunoid**
Trique	Trique	**hv:Matsukawa:Triqui**
Mayabic	Mayabic	**hvs:Breen:Mayi** **hv:BowernAtkinson:Pama-Nyungan**
Osage-Kansa	Osage-Kansa	**s:Rankin:Quapaw**:455
Southern Tibetic	Southern Tibetic	**hv:Tournadre:Tibetic**
Mono-Uruavan	Mono-Uruavan	**hv:EvansPalmer:Southern-Bougainville**
Marrngu	Marrngu	**hv:BowernAtkinson:Pama-Nyungan**
nuw	nuw	Pace **vw:Sakiyama:Nguluwan** Nguluwan is easily a Yapese variety with some influence from Ulithian but not an intertwined language
Ormuri-Parachi	Ormuri-Parachi	**h:Kieffer:Paraci-Ormuri-SEIraniennes**
Southern Periphery Mongolic	Southern Periphery Mongolic	**hv:Nugteren:Qinghai-Gansu**
Lisoid	Lisoid	**hvw:Lama:Nisoic**:153-156 **hv:Bradley:Tibeto-Burman**:101-102
num	num	**g:Tsukamoto:Niuafoou**
nuj	nuj	**v:Schadeberg:Nyole**
nuh	nuh	**hel:Blench:WAfrica**:145
Northern Okani	Northern Okani	**hv:Grollemund:Okani-Nord**
muv	muv	**hlde:Menon:Dravidian**:294-295
mup	mup	**hwsoc:Vargheseetal:Malvi**
Tupi-Guarani Subgroup III	Tupi-Guarani Subgroup III	**hv:RodriguesCabral:Tupi-Guarani**
Chamealic	Chamealic	**hvwt:Grierson:9:IV**
Northwest Solomonic	Northwest Solomonic	**hv:Ross:NWSolomonic**
muc	muc	**hvld:Goodetal:Lower-Fungom**
mub	mub	**hwsoc:Martietal:Kajakse**
mum	mum	**hvld:Lithgow:Milne**
North-Western Tibetic	North-Western Tibetic	**hv:Tournadre:Tibetic**
xve	xve	**v:Gvozdanovic:Venetic**
Turoyo-Mlahso	Turoyo-Mlahso	**s:Jastrow:Turoyo-Mlahso** **v:Kim:Turoyo**
Pimbweic	Pimbweic	**hv:Abe:Gongwe-Bende-Pimbwe** **hv:WalshSwilla:Corridor**
Senufo	Senufo	**hv:Carlson:Senufo** **hb:vonRoncadorMiehe:Gur**
Sara-Bongo-Bagirmi	Sara-Bongo-Bagirmi	**hv:Boyeldieu:Expansion-SBB**
Kanum	Kanum	**hwld:Donohue:Wasur**
Temotu	Temotu	**hv:RossNaess:Temotu**, **hv:NaessBoerger:RSC**, **hvs:Francois:Vanikoro**
unu	unu	**wsoc:Rueck:Unubahe**
Sobei-Liki-Wakde	Sobei-Liki-Wakde	**hwsoc:LeeSawi:Sobei**
Perema-Mumbake	Perema-Mumbake	**vw:Blench:Perema**
coa	coa	**h:AdelaarPrentice:Malay**
Khasian	Khasian	**hvw:Nagarajaetal:Khasian**
coj	coj	**hv:Campbell:1997**
unn	unn	**h:Dixon:Australian2002**:xxxv, 44 **hv:BlakeReid:Victorian**
North_Halmahera	North Halmahera	**hv:GrimesGrimes:NMoluccas** **hv:Voorhoeve:NMoluccas**
Tetelaic	Tetelaic	**g:Jacobs:Tetela** **hvw:Motingea:Nkutsu**
kwh	kwh	**hv:Blust:CEMP**
Baining	Baining	**hv:Stebbins:EBismarcks**
Kuliak	Kuliak	**hv:Heine:Kuliak**:59-66
kwu	kwu	**h:Guthrie:Bantu-Western**
Mangic	Mangic	**hv:Sidwell:Austroasiatic:2015**:169-172
kwx	kwx	**e:Crooke:Kharwar**
frc	frc	**s:Motapanyane:Acadian**
Kamara-Hanga	Kamara-Hanga	**s:Naden:Kamara-Larabanga**
Polynesian	Polynesian	**hv:Wilson:East-Polynesians**
Anatolian	Anatolian	**hv:Melchert:Anatolian**
xxr	xxr	**hv:Ramirez:Koropo**
mcl	mcl	**hvw:Ortiz:Colombia**:133
Tsezic	Tsezic	**w:ComrieKhalilov:Bezhta**:415
Meso Melanesian linkage	Meso Melanesian linkage	**hv:Ross:WMelanesia**:257-314
Njerup	Njerup	**s:ConnellZeitlyn:Njerep**
xxb	xxb	**hvtyp:Heine:Togorest**:300
Yuin	Yuin	**hvw:Waferetal:New-South-Wales** **hv:BowernAtkinson:Pama-Nyungan**
Yasa-Kombe	Yasa-Kombe	**h:Guthrie:Bantu-Western**
Mixe-Zoque	Mixe-Zoque	**ld:Wichmann:Ulterior-Mixe**
Morom-Jaya-Naba	Morom-Jaya-Naba	**hwsoc:Bombay:Bayo-Morbo-Morom-Bolong**
gnu	gnu	**hv:Laycock:Sepik**
slt	slt	**hel:Bradley:EAsia**:365
Manamic linkage	Manamic linkage	**g:Lichtenberk:Manam**:2 **hv:Ross:WMelanesia**:120-132, 418
aip	aip	**hvw:Wilbrink:Kopkaka**
Mabuso	Mabuso	**hw:Zgraggen:Mabuso**
gnb	gnb	**hv:Bradley:Tibeto-Burman**:90
gnc	gnc	**hv:Kossmann:Proto-Berbere**:32-33
aih	aih	**phonv:LinJianxin:Ai-Cham**
Bikwin-Jen	Bikwin-Jen	**hvld:Kleinewillinghofer:Adamawa**
sle	sle	**g:Gowda:Soliga**
haw	haw	**hv:Wilson:Tuamotuan**
gnl	gnl	**hv:Sutton:Gugu-Badhun**:44 **s:Terrill:Biri**:1-4
aib	aib	**s:Lee-Smith:Ejnu**
Bhil	Bhil	**hvwt:Grierson:9:III**
NOCODE_Vili	NOCODE_Vili	**hv:Alewijnseetal:Gabon**
smh	smh	**hsoc:Bradley:Sanie**
Chatino	Chatino	**g:Sullivant:Tataltepec**:8-14
Lahoid	Lahoid	**hvw:Lama:Nisoic**:157-160
Yidgha-Munja	Yidgha-Munja	**hv:Wendtland:Pamir**
Central Eastern Polynesian	Central Eastern Polynesian	**hv:Walworth:Eastern-Polynesian**
Meso-Cordilleran	Meso-Cordilleran	**hv:Himes:Meso-Cordilleran**
Timbe-Selepet-Komba	Timbe-Selepet-Komba	**hvw:McElhanon:Huon**
Nimboranic	Nimboranic	**hvld:Voorhoeve:CWTNG**:421
NOCODE_Yarli	NOCODE_Yarli	**hvw:HercusAustin:Yarli:2004**
NOCODE_Dyarim	NOCODE_Dyarim	**w:Blench:Dyarim**
Western Romance	Western Romance	**hv:Agard:Romance**:80-83
Bororoan	Bororoan	**hvw:Camargos:Bororo**
Asmat-Awyu-Ok	Asmat-Awyu-Ok	**hv:Voorhoeve:Asmat-Kamoro-Awyu-Dumut-Ok**
nix	nix	**e:Thiry:Hema**
NOCODE_Mongoba-Kazibati	NOCODE_Mongoba-Kazibati	**hvb:vanBulck:Congo**:178-184 **hv:HackettvanBulck:ETeam**:74 **hvw:McMaster:Uele**:123, 259
Lumbuic	Lumbuic	**hv:Bastinetal:Bantu**:200
kid	kid	**hvld:Goodetal:Lower-Fungom**
Akum-Beezen	Akum-Beezen	**wsoc:AkumbuBrye:Akum**
Emiliano-Romagnolo	Emiliano-Romagnolo	**hv:Schurr:Romagnolo**
Purus	Purus	**hv:daSilvaBrandao:Arawak**
thn	thn	**hb:RamaiahReddy:Tribal-Dravidian**
Mundaic	Mundaic	**hv:Anderson:Munda**
Bushoong-Wongo-Lele	Bushoong-Wongo-Lele	**hv:Bastinetal:Bantu**:209
thc	thc	**phon:Ferlus:Tai-Nghe-An**
Lower Murray	Lower Murray	**hvw:Horgen:Lower-Murray** **hvw:Waferetal:New-South-Wales**:26-29 **hv:BowernAtkinson:Pama-Nyungan**
Maningrida	Maningrida	**hv:Green:Maningrida**
yel	yel	**h:Hulstaert:Cuvette-Congolaise**:23 **hv:Mangulu:Bassin-Congolais**
yea	yea	**hw:Bhattacharya:South-Kerala**
Eastern Yapen	Eastern Yapen	**hv:Kamholz:South-Halmahera-West-New-Guinea**:139
yey	yey	**v:Seidel:Yeyi**
Alumic	Alumic	**hv:Blench:Plateau:2009**
yeu	yeu	**hb:RamaiahReddy:Tribal-Dravidian**
Kilba-South Margi	Kilba-South Margi	**g:Hoffmann:Margi**:5-8
Southern Cordilleran	Southern Cordilleran	**hv:Himes:Southern-Cordilleran**
haj	haj	**wsoc:Ahmadetal:Hajong**
Fali-Gude	Fali-Gude	**g:Hoskison:Gude**:3
Sangu-Sira-Punu	Sangu-Sira-Punu	**hv:Alewijnseetal:Gabon**
txh	txh	**ld:BrixhePanayotou:Thrace**
Southern Sabi	Southern Sabi	**hv:Bastinetal:Bantu**
bnl	bnl	**h:Lamberti:Somali**:159-162
hap	hap	**h:SilzerClouse:Index** **hvw:Bromley:Dani**
NOCODE_Miisiirii	NOCODE_Miisiirii	p.c.~George Starostin 2014
Eskimo-Aleut	Eskimo-Aleut	**hv:Berge:Eskimo-Aleut** **hv:Campbell:1997**
Jurua-Jutai	Jurua-Jutai	**hvw:Ramirez:Arawak**
elu	elu	**hvsoc:SchoolingSchooling:Manus**
Boana	Boana	**hv:HooleyMcElhanon:Morobe**:1072-1073
Flores-Lembata	Flores-Lembata	**hv:Doyle:Flores-Lembata**
Kangri-Dogri	Kangri-Dogri	**g:Eaton:Kangri** **g:Sharma:Kangari**:16-18
lcf	lcf	**hb:Voorhoeve:Sumatra**
Lega Complex	Lega Complex	**h:Biebuyck:Lega**
lce	lce	**e:Helbig:Bangka** **ld:Riedel:Sekah**
lcl	lcl	**hvsoc:Grimes:Buru**
Aru	Aru	**hv:Collins:Maluku** **hv:Hughes:Kei-Tanimbar-Aru**
Western Gunwinyguan	Western Gunwinyguan	**g:Evans:Bininj-Gun-Wok**:32-35 **hvld:Harvey:WGunwinyguan**
bpj	bpj	**s:vanCollie:Mbagani**
Kamic	Kamic	**s:YangEdmondson:Kam**
Baic	Baic	**hv:Dell:Bai**
bpt	bpt	Notwithstanding **hv:Koch:Methodological**:37-39 the Barrow Point vocabulary in **hew:HaleTindale:Charlotte-Bay** shows exclusive matches with Flinders Island
ywa	ywa	**hsoc:Hutchinson:Heyoetc**:123
Botatwe	Botatwe	**hv:deLuna:Botatwe**
Badaic	Badaic	**hvld:Martens:Badaic**
bpx	bpx	**e:Mann:Indian**
Dolpo-Tichurong	Dolpo-Tichurong	**soc:Jest:Dolpo**
Tshanglic	Tshanglic	**g:Andvik:Tshangla**
NOCODE_Nitita	NOCODE_Nitita	**h:Crowley:Avava:Introduction**
Ambulas-Hanga-Hundi	Ambulas-Hanga-Hundi	**g:Wendel:HangaHundi**:1-4
Moroccan-Andalusian Arabic	Moroccan-Andalusian Arabic	**ld:Corriente:Andalusi-Arabic**
Yanzi (B.80)	Yanzi (B.80)	**hv:Bastinetal:Bantu**:202-203
Nyo-Yo	Nyo-Yo	**phon:Boonsner:Yooy**:63-89
Italic	Italic	**hv:Rix:Italischen**
Sauk-Nimi	Sauk-Nimi	**hv:HooleyMcElhanon:Morobe**:1073
yka	yka	**g:BrainardBehrens:Yakan**
ykk	ykk	**w:Budita:Yakaikeke**
Cahuapanan	Cahuapanan	**hv:Valenzuela:Cahuapana**
yko	yko	**s:BouhMaSitna:Yasa**
fod	fod	**typ:Fiedler:Foodo**
iwo	iwo	**he:BrongersmaVenema:Witte**
NOCODE_Old-Wanji	NOCODE_Old-Wanji	**hv:EdelmanDodykhudoeva:Pamir**
Southwestern Shifted Romance	Southwestern Shifted Romance	**hv:Agard:Romance**:91-99
Chuanqiandian	Chuanqiandian	**styp:McLaughlin:Hmong-Soud**:6-10
ykt	ykt	**hvsoc:Pelkey:Phula**:458 **h:Hsiu:Southwestern-China**
umi	umi	**hv:Rensch:Central-Sarawak** **e:Sellato:Bukat-Kereho**:20-21
eya	eya	**hv:Leer:AET**
Western Tibeto-Kanauri	Western Tibeto-Kanauri	**hvw:Widmer:West-Himalayish**
plq	plq	**hv:Melchert:Anatolian**
plp	plp	**hvwt:Grierson:9:IV**
Yandang	Yandang	**hvw:Blench:Yendang**
bpy	bpy	**hwdial:KimKim:Bishnupriya**
pln	pln	**ld:BickertonEscalante:Palenquero**
pli	pli	**s:Oberlies:Pali**
obl	obl	**hsoc:AyotteAyotte:Dama**
Tatic	Tatic	**hvsoc:Stilo:Tati**
NOCODE_Navwien	NOCODE_Navwien	**hv:Lynch:Malakula**
zuh	zuh	**s:Anonymous:Tokano**
obr	obr	**phon:Yanson:Drevnebirmanskogo**
Southeastern Pama-Nyungan	Southeastern Pama-Nyungan	**hv:BowernAtkinson:Pama-Nyungan**
NOCODE_Daohua	NOCODE_Daohua	**g:Acuo:Dao**
zum	zum	**hvw:Anonby:Luri**
soe	soe	**h:Hulstaert:Cuvette-Congolaise**:24
Southern Njila	Southern Njila	**hv:Vansina:West-Central-Africa**:273-283
soi	soi	**h:Ethnologue:16**
Bukitanic-Busangic	Bukitanic-Busangic	**he:SellatoSercombe:Borneo-Hunter-Gatherer**:12 **hv:Rensch:Central-Sarawak**
mba	mba	**hv:Burton:East-Mindanao-Manobo**:57
two	two	**hld:AnderssonJanson:Botswana**:42-46 **hv:Batibo:Bantu-Botswana**:25
mby	mby	**ld:Katiya:Memoni**
mbz	mbz	**hdial:Eglandetal:Mexico**
soy	soy	**s:Rongier:Moyobe**
sox	sox	**dial:BradleyBradley:Sso**
Paman	Paman	**hv:Hale:Paman**
waj	waj	**d:HotzStringer:Waffa**
North African Arabic	North African Arabic	**hv:Pereira:Arabic-North-African**
gix	gix	**hvw:BoyeldieuCloarec-Heiss:Oubanguien**
Ethiosemitic	Ethiosemitic	**hv:Weninger:Ethio-Semitic** **hv:Voigt:North-South-Ethiopian**
Kosena-Awiyaana	Kosena-Awiyaana	**s:Marks:Kosena** **hv:McKaughan:Gadsup-Auyana-Awa-Tairora**
gid	gid	**hv:Gravina:Central-Chadic**:61-62
Tucanoan	Tucanoan	**hv:Chacon:Proto-Tukanoan**
Yaunde-Fang (A.70)	Yaunde-Fang (A.70)	**phontyp:Piper:Pahouin**
wat	wat	**hvld:Lithgow:Milne**:460
Huitotoan	Huitotoan	**hv:SeifartEcheverri:Bora-Witotoan**
Aari-Gayil	Aari-Gayil	**soc:Jordanetal:Gayil** **hvw:Tsuge:SOmotic**
Luo-Burun	Luo-Burun	**vld:Andersen:Jumjum**
Songhay	Songhay	**hv:Souag:Songhay**
Northern Ngayarda	Northern Ngayarda	**hv:BowernAtkinson:Pama-Nyungan**
twx	twx	**sd:Locati:Chiute**
mty	mty	**hvw:Laycock:Lumi**:48
Caspian	Caspian	**h:Lecoq:Caspiens** **hvsoc:Stilo:Tati**
mtw	mtw	**hld:Llamzon:Philippine**:116
NOCODE_Ngubi	NOCODE_Ngubi	**phonv:Agadji:Ngubi**:79-83
Bebeli-Mangseng	Bebeli-Mangseng	**hv:Chowning:WNewBritain**
Yangum	Yangum	**hv:Laycock:Sepik**
xwc	xwc	**vw:Rudes:Woccon**
Yukubenic	Yukubenic	**hvtyp:Prischnegg:Yukuben**
nne	nne	**ld:Fourie:Ngandjera**
Yukaghir	Yukaghir	**vw:Nikolaeva:Chuvan-Omok**
South Pentecost	South Pentecost	**hvb:LynchCrowley:Vanuatu**
nnu	nnu	**hvw:Painter:Guang**
NOCODE_Mawakwa	NOCODE_Mawakwa	**hv:Loukotka:SAmerica**
vwa	vwa	**phon:Watkins:Wa**
Greater Chuanqiandian	Greater Chuanqiandian	**hvb:Niederer:Hmong-Mjen** **hv:Johnson:Far-Western-Hmongic**
xkk	xkk	**hel:Bradley:SEAsia**
tiz	tiz	**hv:EdmondsonSolnit:Shan**
Sepik Hill	Sepik Hill	**hvw:ConradLewis:USepik** **hvw:Dyeetal:Sepik-Hill**
xkc	xkc	**s:Yarshater:Xoini**
Sentanic	Sentanic	**hv:HartzlerGregerson:Proto-Tabla-Sentani**
Bebe-Kemezung	Bebe-Kemezung	**soc:BryeBrye:Bebe-Kemezung** **hsoc:BryeBrye:Eastern-Beboid**
tiq	tiq	**typ:Winkelmann:Cefo**
tij	tij	**s:Opgenort:Tilung**:334-340 **v:Opgenort:Tilung**
Ojibwa	Ojibwa	**hv:RhodesTodd:Subarctic-Algonquian**:62
Tumbukic	Tumbukic	**h:Young:Nyasaland**
Je Central	Je Central	**v:OrphaoDamulakis:Akroa-Xakriaba**
xkv	xkv	**wdial:Kalasi:Sekgalagari**
Eastern Timoric A	Eastern Timoric A	**v:vanEngelenhoven:Makuva**
Durango Nahuatl	Durango Nahuatl	**ldsoc:Canger:Nahuatl-Durango-Nayarit**
Toba-Batak	Toba-Batak	**hv:Adelaar:Proto-Batak**
NOCODE_Mikaya-Bambengangale-Baluma	NOCODE_Mikaya-Bambengangale-Baluma	**hvw:Klieman:WEquatorial**:304
East Chadic B	East Chadic B	**hv:Lovestrand:Chadic-Guera**
Potou-Tano	Potou-Tano	**hv:Stewart:Kwa**
Agaw	Agaw	**hv:Appleyard:Agaw:1984**
Sukuma-Nyamwezi (F.20)	Sukuma-Nyamwezi (F.20)	**hv:Nurse:Western-Tanzania**
Nuclear Bodo	Nuclear Bodo	**hv:Burling:NEIndia**:177
Kinnauric	Kinnauric	**hv:SaxenaBorin:West-Himalayish** **hvw:Widmer:West-Himalayish**
kvx	kvx	**typ:Hoyle:Parkari**
Dayic	Dayic	**hvw:Blust:Saban** **hv:Kroeger:Sarawak**
Omo-Tana	Omo-Tana	**hv:Tosco:Cushitic**:94-95
Tupi-Guarani Subgroup I	Tupi-Guarani Subgroup I	**hv:Mello:Tupi-Guarani** **hv:RodriguesCabral:Tupi-Guarani** **hv:Rodrigues:Xeta**
Tupi-Guarani Subgroup V	Tupi-Guarani Subgroup V	**hv:RodriguesCabral:Tupi-Guarani**
Tai-Kadai	Tai-Kadai	**hv:EdmondsonSolnit:Kadai-Tai:Introduction**
Guinea Coast Creole English	Guinea Coast Creole English	**hvw:Hancock:Anglophone**
llq	llq	**v:Sneddon:Lolak**
llh	llh	**hv:Bradley:Tibeto-Burman**:104
Chinantecan	Chinantecan	**hb:Merrifield:Chinantec**
nlu	nlu	**hvw:Painter:Guang**
ror	ror	**el:Arka:Rongga**:90
Arapahoic	Arapahoic	**hvw:Kroeber:Arapaho**
Chokwe-Lunda	Chokwe-Lunda	**hv:Bastinetal:Bantu**:216
bqd	bqd	**el:Connell:Nigeria-Cameroon**:216
bqa	bqa	**hvw:Bertho:Moyen-Dahomey**
Eastern Arabic	Eastern Arabic	**hv:Talay:Arabic-Mesopotamia**
bqh	bqh	**hv:Tournadre:Tibetic** **vw:Chirkova:Baima**
Monde	Monde	**hv:Moore:Monde**
bqu	bqu	**hvw:McMaster:Uele**:242, 263
bqr	bqr	**w:Appel:Bulusu** **hv:Lobel:Southwest-Sabah**
Bena-Mboi	Bena-Mboi	**hvld:Kleinewillinghofer:Adamawa**
NOCODE_Pinghua	NOCODE_Pinghua	**hv:Wang:Han**:117-118
Khoe	Khoe	**hvphon:Vossen:Khoe**
Saharan	Saharan	**hv:Cyffer:Saharanischen**
NOCODE_Giya	NOCODE_Giya	**hv:Breen:Biri**
Kham-Magar-Chepang	Kham-Magar-Chepang	**g:Grunow-Harsta:Magar**
Seko	Seko	**hv:Laskowske:Seko**
lrv	lrv	**g:Crowley:Naman**:18
Eastern Mande	Eastern Mande	**hv:Dwyer:Mande:1989**  **hv:Dwyer:Mande**
Ghera-Gurgula	Ghera-Gurgula	**hsoc:Rahman:Pakistan**
Bisayan	Bisayan	**hv:Zorc:Bisayan**
Dizoid	Dizoid	**hv:Aklilu:Maji** the similarities between Sheko and Nayi in historical phonology are all retentions and therefore do not count as evidence for a Sheko-Nayi node
Guyanic Creole French	Guyanic Creole French	**hdial:Anonby:Amapa** **hv:Corne:French-Creole**
Taa	Taa	**typdial:Naumann:Taa**
Eastern Victoria	Eastern Victoria	**hv:BowernAtkinson:Pama-Nyungan**
dit	dit	**g:Austin:Diyari**
diu	diu	**hv:Mohlig:Kavango**
Mlap-Gresi-Kemtuik	Mlap-Gresi-Kemtuik	**g:Anceaux:Nimboran**:2 **phon:vanderWildenvanderWilden:Kemtuk**:32
Nyali-Ndaka-Mbo-Budu-Vanuma	Nyali-Ndaka-Mbo-Budu-Vanuma	**s:Kutsch:Bila**:450-452
pmu	pmu	**s:Anonymous:Mirpuri**
xkt	xkt	**h:Kropp:Ghana:Other**:168
hti	hti	**hv:Collins:Maluku**
Romance	Romance	**hv:Leonard:Romance** **hv:Agard:Romance**:61-73
Mambiloid	Mambiloid	**hv:Blench:Bantoid**
pmn	pmn	**hv:Elders:Kebi-Benue**
pmh	pmh	**v:Bloch:Marathe**
nlk	nlk	**e:Wilson:Yali-Heluk**
Taos-Picuris	Taos-Picuris	**hvbtyp:Sutton:Kiowa-Tanoan**:1168-1173
Au-Olo-Elkei	Au-Olo-Elkei	**hvw:Laycock:Lumi**:48
Bungku-Tolaki	Bungku-Tolaki	**hvs:Mead:Bungku-Tolaki**
North_Bougainville	North Bougainville	**g:Robinson:Rotokas**:17-24
Corachol-Aztecan	Corachol-Aztecan	**hv:Hill:Uto-Aztecan**
Kaike-Ghale-Tamangic	Kaike-Ghale-Tamangic	**vphon:Honda:Kaike**
zrn	zrn	**wsoc:Johnson:Zirenkel**
Southern Melanesian	Southern Melanesian	**hv:Lynch:Efate-Erromango**
Tupi-Guarani Subgroup VI	Tupi-Guarani Subgroup VI	**hv:RodriguesCabral:Tupian**
Lower Baram	Lower Baram	**hv:Kroeger:Sarawak**
Alabat-Manide Agta	Alabat-Manide Agta	**vw:Lobel:Manide**
ekl	ekl	**hwsoc:Kimetal:Santali**:25
Peba-Yagua	Peba-Yagua	**hv:Pena:Peba-Yaguan**, **hv:GildeaPayne:Macro-Carib**
Wanji-Sangu	Wanji-Sangu	**hv:Nurse:SWTanzania**:92
bok	bok	**wsoc:Gardner:Epena**
Yugambalic	Yugambalic	**hvw:Waferetal:New-South-Wales**:332-340
jat	jat	**h:Kieffer:Afghanistan**
bof	bof	**g:Zoungrana:Bolon** **g:Vydrine:Kagoro**
ngo	ngo	**v:Ngonyani:Ngoni**
Turama-Kikori	Turama-Kikori	**hv:Franklin:Other**:263-267
Hmong-Mien	Hmong-Mien	**hv:Ratliff:Hmong-Mien**
Enya (D.10)	Enya (D.10)	**hv:Bastinetal:Bantu**:209
Limba	Limba	**hv:Pozdniakov:Atlantiques**
West Nyanza	West Nyanza	**hvw:Schoenbrun:Great-Lakes-Bantu**, **hv:Schoenbrun:Great-Lakes-Bantu:1994**
Sahaptian	Sahaptian	**hv:Campbell:1997**
ayg	ayg	**hvw:Painter:Guang**
Eastern Malakula linkage	Eastern Malakula linkage	**hv:LynchBrotchie:Tirax**
msi	msi	**h:AdelaarPrentice:Malay**
ayu	ayu	**w:Blench:Ayu**
Chumashan	Chumashan	**hv:JonesKlar:Polynesian-Southern-California**
Kainji	Kainji	**hvw:Blench:WKainji** **g:McGill:Cicipu** **hv:McGill:Kainji**
Northwestern Moroccan Berber	Northwestern Moroccan Berber	**hv:Kossmann:Arabic-Berber**:21
Ohio Valley Siouan	Ohio Valley Siouan	**hv:OliverioRankin:Virginia-Siouan**
Wahgic	Wahgic	**hvld:Capell:SWPacific:1962**:105-128
ibe	ibe	**hv:Blench:Akpes** **hv:Elugbe:Akpes-AIKA**
Indonesian Archipelago Malay	Indonesian Archipelago Malay	**hv:Adelaar:Malayic:Structural**
caj	caj	**hv:Loukotka:SAmerica**:144
Gurma	Gurma	**hvw:Manessy:Gurma**
ull	ull	**hw:Bhattacharya:South-Kerala** **he:Singh:Scheduled**:544
fln	fln	**hv:Koch:Methodological**:37-39 **hv:BowernAtkinson:Pama-Nyungan**
Kotoko Meridional	Kotoko Meridional	**hv:Gravina:Central-Chadic**:61
Danaw	Danaw	**hv:Allison:Danaw**
Ladakhic	Ladakhic	**hvtyp:Zeisler:Tibetan**
Ngumpin-Yapa	Ngumpin-Yapa	**hv:BowernAtkinson:Pama-Nyungan**:834-836 Positive evidence for an Eastern Ngumpin branch is lacking in **hv:McConvellLaughren:Ngumpin-Yapa**
Tamiloid	Tamiloid	**hvlde:Zvelebil:Nilagiri**
kyn	kyn	p.c.~Jason Lobel 2012
uan	uan	**he:Schliesinger:Austro-Thai**
kyg	kyg	**hvld:Wurm:ECTNG**
Western Admiralty Islands	Western Admiralty Islands	**hvw:Blust:Western-Islands**:40
Negro-Roraima	Negro-Roraima	**hvw:Ramirez:Arawak**:511-532
Luvian	Luvian	**s:Melchert:Luvian**
kyy	kyy	**hvsoc:WurmLaycock:NG**:138
mgg	mgg	**soc:BeavonJohnson:Bekwel**
kyw	kyw	**hvw:Grierson:5:II**
spe	spe	**hvld:Zgraggen:Madang**:189
spg	spg	**w:Sandin:Sian**:70
Nuclear Tirio	Nuclear Tirio	**hwsoc:JoreAleman:Tirio**
nyr	nyr	**hwsoc:Lindforsetal:Nyiha-Nyika**
nys	nys	**hv:BowernAtkinson:Pama-Nyungan**
Zazao-Blanga	Zazao-Blanga	**hv:Voica:Isabel**
nyu	nyu	**s:vanderMohl:Tete**
nyc	nyc	**hv:HackettvanBulck:ETeam**:74 **hv:vanBulck:Bantoetaalgrens**
Lamalamic	Lamalamic	**s:Laycock:Lamalamic**
Three Rivers	Three Rivers	**hvw:Collins:CMaluku**:34-60
nye	nye	**hv:Fortune:Barotseland**
Germanic	Germanic	**hv:Stiles:West-Germanic**:8-10
aob	aob	**el:Tupper:Abom**
Tani	Tani	**hv:Post:Defoliating-Tani**
Fipa-Mambwe-Lungu	Fipa-Mambwe-Lungu	**hv:Nurse:SWTanzania**:91
yir	yir	**hsoc:Susanto:Mapi** **hwsoc:KriensLebold:Wildeman**:26
snu	snu	**hvw:Voorhoeve:Miscellaneous**
ylo	ylo	**hel:Bradley:EAsia**:399
Kele (C.60)	Kele (C.60)	**hv:Bastinetal:Bantu**:208
South Bahnaric	South Bahnaric	**hv:Sidwell:SBahnaric**
Southern Lwoo	Southern Lwoo	**hvw:Heusing:Lwoo**
ghr	ghr	**hsoc:Rahman:Pakistan**
Ede	Ede	**hvwsoc:Kluge:Ede**
Dangari	Dangari	**hv:Liljegren:Dangari** **s:Liljegren:Kalkoti**
Central Sogeram	Central Sogeram	**typ:Daniels:Sogeram**
Pasismanua	Pasismanua	**hv:Chowning:WNewBritain**
gha	gha	**hv:Kossmann:Proto-Berbere**:31 **hv:Kossmann:Arabic-Berber**:25
Daju	Daju	**hv:Thelwall:Daju**
Austronesian	Austronesian	**hv:Ross:Nuclear-Austronesian** **hv:Ross:Proto-Austronesian:Verbal** **hv:Blust:Austronesian**
Central Philippine	Central Philippine	**hv:Zorc:Bisayan** **hv:Blust:CPhilippines**
Miahuatec	Miahuatec	**ld:Azcona:San-Agustin-Mixtepec-Zapotec**
Greater SHWNG	Greater SHWNG	**hv:Kamholz:South-Halmahera-West-New-Guinea**:31-32
Eastern Iranian	Eastern Iranian	**hv:Schmitt:Iranischen**
Walio	Walio	**hvw:ConradLewis:USepik**
Arawakan	Arawakan	**hv:Aikhenvald:Arawak**
lss	lss	**hvw:Grierson:8:I**
jid	jid	**w:Blench:Bu**
Kulawi	Kulawi	**std:AdrianiEsser:Koelawische**
Akpes-Edoid	Akpes-Edoid	**hv:Elugbe:Akpes-AIKA**
Waic	Waic	**hv:Diffloth:Wa**
East Chadic A.1 2	East Chadic A.1 2	**hb:BarreteauNewman:Tchadiques**
Basaa (A.40)	Basaa (A.40)	**hv:Gerhardt:Bantu**
xyy	xyy	**hv:Blake:Kulin**
enu	enu	**hsoc:Bradley:Yi-Planning**:84
Ong-Ta'oih	Ong-Ta'oih	**phon:Ferlus:Ong**:113
Mid-Southern Central Core Banda	Mid-Southern Central Core Banda	**hdial:Cloarec-Heiss:Banda**
noe	noe	**wsoc:Vunnamatlaetal:Nimadi**
Rungwa-Pimbwe	Rungwa-Pimbwe	**hv:Nurse:SWTanzania**:91
tjn	tjn	**vw:Kastenholz:Tonjon**
tju	tju	**hv:Dench:Pilbara:Pronoun**
kkj	kkj	**h:Guthrie:Bantu-Western**
Shinaic	Shinaic	**hvld:Bashir:Dardic**
Inagta Bikol	Inagta Bikol	**hv:Reid:Negrito** p.c.~Jason Lobel 2012
noq	noq	**hv:BostoenKoni:Kwilu**
ulb	ulb	**h:MordiOpone:Enuani**
Omagua-Kokama	Omagua-Kokama	**hv:WautersOHagan:Omagua-Kokama**
xld	xld	**hv:Melchert:Anatolian**
Tamolan	Tamolan	**hvld:Zgraggen:Madang**:151-155
Gunwinyguan Bak	Gunwinyguan Bak	**g:Evans:Bininj-Gun-Wok**:32-35  **hv:Baker:Gunwinyguan**
xls	xls	**hv:Clackson:Indo-European**:3-9
Flores-Sumba-Hawu	Flores-Sumba-Hawu	**hv:Blust:Bima-Sumba**
Dhimalish	Dhimalish	Contra **hv:vanDriem:Himalayas**:548-567 Dhimalish fails to show sufficient Brahmaputran diagnostic vocabulary
Sangiric	Sangiric	**hvw:Sneddon:Proto-Sangiric**
NOCODE_Jabal-Razih	NOCODE_Jabal-Razih	**ld:Watsonetal:Razih**
Northern Burmish	Northern Burmish	**hv:Mann:NBurmic**
Tibetic	Tibetic	**hv:Tournadre:Tibetic**
Yanomamic	Yanomamic	**hv:Migliazza:Yanomama** **s:Ferreira:Yaroame**
Circum-Caribbean French	Circum-Caribbean French	**hv:Corne:French-Creole**
Cenderawasih Bay	Cenderawasih Bay	**hv:Kamholz:South-Halmahera-West-New-Guinea**:138
Zarma-Kaado-Dendi	Zarma-Kaado-Dendi	**hvw:Harrison:Southern-Songhay**
Siouan	Siouan	**hv:Campbell:1997**
Jingpho-Luish	Jingpho-Luish	Contra **hv:Matisoff:Jingpho**:2-3 the semantic change of the diagnostic SAL words are diagnostic of the Brahmaputran subgrouping
Iatmulic	Iatmulic	**hw:Staalsen:Sawos**:11 **soc:Richardson:Kundi-Ambakich** **g:Jendraschek:Iatmul**:4-8
Koiarian	Koiarian	**hv:Dutton:Proto-Koiarian**
erw	erw	Data in **hw:SmitsVoorhoeve:Anceaux:A:I**, **hw:SmitsVoorhoeve:Anceaux:A:II** shows that Arguni-Bedoanas-Erokwanas forms a dialect continuum
Highlands Chamic	Highlands Chamic	**hv:Thurgood:Cham**
blj	blj	**hv:Lobel:Southwest-Sabah**:401
Bilic	Bilic	**hv:Walton:Philippine** **v:Blust:Tiruray**
Kulin-Bunganditj	Kulin-Bunganditj	**hv:BowernAtkinson:Pama-Nyungan**
ort	ort	**d:Gustafsson:Adiwasi-Oriya** **sd:Mahapatra:Desia**
Gyalsumdo-Nubri-Kyirong	Gyalsumdo-Nubri-Kyirong	**phon:HildebrandtPerry:Gyalsumdo**
orn	orn	**he:Carey:Orang-Asli**:236-239
Coastal Chamic	Coastal Chamic	**hv:Thurgood:Cham**
NOCODE_Pyu-Burma	NOCODE_Pyu-Burma	**hv:Bradley:Tibeto-Burman**
lmn	lmn	**g:Trail:Lamani**
gir	gir	**v:Li:Hong-Gelao**
Nuclear Bwamu	Nuclear Bwamu	**hwsoc:BertheletteBerthelette:Bwamu**
Mianic	Mianic	**g:Fedden:Mian**
jwi	jwi	**soc:Ntumy:Jwira**
yuj	yuj	See **hb:Hammarstrom:Least**
Oumic	Oumic	**hvwld:Dutton:Magori**
NOCODE_Orkon	NOCODE_Orkon	**hvb:LynchCrowley:Vanuatu**:96 inspection of the unpublished wordlists puts it with Port Vato and Daakaka
Yoruboid	Yoruboid	**h:Capo:Defoid** **hv:Akinkugbe:Yoruboid**
Western Periphery-North Guerrero Nahuatl	Western Periphery-North Guerrero Nahuatl	**hv:Canger:Nahuas:1988**:480-483 **hv:Canger:Nahuatl:1978** **hv:Dakin:Uto-Aztecan**
mkk	mkk	**soc:Etter:Byep**
Kao River	Kao River	**hv:GrimesGrimes:NMoluccas**:52-53
NOCODE_Mokpa	NOCODE_Mokpa	**s:Mangulu:Mokpa**
Kwangali-Diriku	Kwangali-Diriku	**hv:Vansina:West-Central-Africa**:273-283
Marindic	Marindic	**hv:Voorhoeve:CSNG** **hvld:Voorhoeve:CWTNG**
Sama-Bajaw	Sama-Bajaw	**hvw:Pallesen:Convergence**
Kayan-Kenyah	Kayan-Kenyah	**hv:Soriente:Kenyah**
Kunene	Kunene	**s:Elderkin:Herero**:583 **hv:Vansina:West-Central-Africa**:273-283
Bantu H12-16c	Bantu H12-16c	**hv:Bostoen:Kikongo**
Buwal-Gavar	Buwal-Gavar	**soc:Brye:Buwal-Gavar**
NOCODE_Nabit	NOCODE_Nabit	**vld:Giffen:Nabit**
yiq	yiq	**vld:Gao:Micha** **hel:Bradley:EAsia**:363, 398-399
yip	yip	**hvsoc:Pelkey:Phula**
Eastern Taupota	Eastern Taupota	**wsoc:Cooperetal:Haigwai**
Olo-Elkei	Olo-Elkei	**hv:Laycock:Torricelli**:768
South Halmahera	South Halmahera	**hv:Kamholz:South-Halmahera-West-New-Guinea**:137
hud	hud	**h:Taber:Maluku**:58
Voh-Kone	Voh-Kone	**hbld:Haudricourt:New-Caledonia-Loyalty**
Kuri	Kuri	**hv:BowernAtkinson:Pama-Nyungan**
pnq	pnq	**g:Beyer:Pana**
Marne	Marne	**g:Evans:Bininj-Gun-Wok**:32-35
huw	huw	**el:Grimes:Kayeli-Hukumina**
xpr	xpr	**hv:Schmitt:Iranischen**
Rajasthani	Rajasthani	**hvwt:Grierson:9:II**
Mirning	Mirning	**hv:BowernAtkinson:Pama-Nyungan** **hv:Nash:SEWAustralia**
Kotoko Central	Kotoko Central	**hv:Gravina:Central-Chadic**:60-61
NOCODE_Vivti	NOCODE_Vivti	**h:Crowley:Avava:Introduction**
anl	anl	**s:Wright:Hkongso**
Negrosanon	Negrosanon	p.c.~Jason Lobel 2012
ant	ant	**hv:Ogradyetal:LW:82**:38-39
saz	saz	**hvwt:Grierson:9:II**
anp	anp	**hvw:Grierson:5:II**:95-104
anr	anr	**e:RussellHiralal:Andh**
saw	saw	**hvw:Voorhoeve:Irian**
Kewieng-Bonkiman-Nokopo	Kewieng-Bonkiman-Nokopo	**hv:HooleyMcElhanon:Morobe**:1074
Northern Njila	Northern Njila	**hv:Vansina:West-Central-Africa**:273-283
NOCODE_Nisvai	NOCODE_Nisvai	**hv:Lynch:Malakula**
NOCODE_Hungu	NOCODE_Hungu	**s:Atkins:Hungu**:163-164
Southeastern Bengali	Southeastern Bengali	**hvld:Chowdhury:East-Pakistan**
Momo	Momo	**hvtyp:Stallcup:Moghamo-Ngie-Oshie**
gko	gko	**hv:Black:Norman-Pama**
Pacific Creole English	Pacific Creole English	**hv:Clark:Beach-la-mar**
Mbundu (H.20)	Mbundu (H.20)	**hv:Vansina:West-Central-Africa**:273-283 **h:Bryan:Bantu**
Dida	Dida	**hv:Kaye:Dida**
Ijoid	Ijoid	**hv:Jenewari:Ijoid**, **hv:Connelletal:Defaka-Ijo**
Teor-Kur	Teor-Kur	**hv:Collins:Maluku**:122-123
Southern Burmish	Southern Burmish	**hv:Bradley:Tibeto-Burman:1997**:39-41
Shan Tai	Shan Tai	**hv:Edmondson:Shan**
NOCODE_Caijia	NOCODE_Caijia	**h:Hsiu:Southwestern-China**
tdv	tdv	**w:Blench:Toro**
wnm	wnm	**sv:BlakeBreen:Pitta-Pitta**
Fore-Gimi	Fore-Gimi	**hvw:Scott:East-Central**:163-197
mrx	mrx	**hwsoc:LeeWambaliau:Kwanem**
mry	mry	**hv:Gallman:East-Mindanao**
Njemic	Njemic	**hv:Cheucle:Makaa-Njem**:516 **typ:Beavon:Konzime**:2-3
mru	mru	**hv:Elders:Kebi-Benue**
Yamphuic	Yamphuic	**hwsoc:HiltyMitchell:Yamphu**:52
mro	mro	**hv:vanDriem:Himalayas**:588-589
Yarli-Baagandji	Yarli-Baagandji	**hv:BowernAtkinson:Pama-Nyungan**:832-833 **hvw:Waferetal:New-South-Wales**
Kongo-Yaka-Suku-Hungan	Kongo-Yaka-Suku-Hungan	**hv:Bostoen:Kikongo**
pwb	pwb	**ld:BlenchNengel:Panawa**
mra	mra	**hv:Rischel:Mlabri-Mon-Khmer**
tkb	tkb	**e:Crooke:Bhoksa**
NOCODE_Ngumbarl	NOCODE_Ngumbarl	**hv:Bowern:Nyulnyulan-Jigsaw**
tkv	tkv	**w:Carteretal:Mur**
Tharuic	Tharuic	**hvw:Boehm:Tharu**
tkt	tkt	**soc:Boehm:Tharu**
Eastern Kainji	Eastern Kainji	**h:Blench:East-Kainji**
Sko	Sko	**hvphon:Donohue:Skou**, **hvld:DonohueCrowther:NCNG**, **g:DonohueRoque:Isaka**
tkz	tkz	**hv:Sidwell:Cua-EBahnaric**
nlo	nlo	**s:Bwantsa-Kafungu:Ngwii**
zgm	zgm	**hev:JohnsonWang:Zhuang**
xma	xma	**phon:Hout:Mushunguli**:1
Paguic	Paguic	**s:Wimbish:Pagu**:6
NOCODE_Penange	NOCODE_Penange	**g:Heath:Penange**
geq	geq	**phon:BoydNougayrol:Geme**
kxk	kxk	**hv:Bradley:Tibeto-Burman**:107
ssu	ssu	**el:Smith:Susuami**
NOCODE_Middle-Indo-Aryan	NOCODE_Middle-Indo-Aryan	**s:Bubenik:Prakrits**
ssq	ssq	**w:DjawanaiGrimes:Ngada**
Alor-Pantar	Alor-Pantar	**hv:HoltonRobinson:Alor-Pantar:Internal**
ssi	ssi	**hvwld:Grierson:11**
kxp	kxp	**hsoc:Rahman:Pakistan**
kxt	kxt	**hw:Staalsen:Sawos**:11
Eastern Beboid	Eastern Beboid	**hsoc:BryeBrye:Eastern-Beboid**
Afghanistan-Uzbekistan Arabic	Afghanistan-Uzbekistan Arabic	**w:Sirat:Arabic-Balkh**
Kinalakna-Kumukio	Kinalakna-Kumukio	**hv:HooleyMcElhanon:Morobe**:1071
rmt	rmt	**hv:Matras:Romani**:14-48 **s:Herin:Domari-Aleppo**
rmx	rmx	**h:WRITENET:Vietnam**
Konyak	Konyak	**hv:Burling:NEIndia**
lnl	lnl	**w:Simonsetal:Ngbugu**
Alto Orinoco	Alto Orinoco	**hvw:Ramirez:Arawak**:499-510 **htyp:Zamponi:Maipure-Yavitero**:584-585
Central-Southwestern Tai	Central-Southwestern Tai	**hv:Pittayaporn:Proto-Tai**:286-304 (called G)
rmi	rmi	**hv:Matras:Romani**:14-48
Kenyahic	Kenyahic	**hv:Sellato:Kenyah-Putuk**:29
East Polynesian	East Polynesian	**hv:Marck:Polynesian**
Gyalrongic	Gyalrongic	**hvld:Sun:rGyalrong** **hwdial:Gates:Jiarong**
vkp	vkp	**g:Clements:Korlai** **hv:Ferraz:WAfrica**
ytw	ytw	**wsoc:Gray:Domung**
Khoe-Kwadi	Khoe-Kwadi	**hv:GuldemannElderkin:Khoe-Kwadi**
vki	vki	**typ:Obatoye:Koro-Ija**
ytl	ytl	**hv:Bradley:Tibeto-Burman**
vkk	vkk	**hb:Voorhoeve:Sumatra**
Baniwa-Curripaco-Tariano	Baniwa-Curripaco-Tariano	**hvw:Ramirez:Arawak**:37-229 **hv:Aikhenvald:North-Arawak**
Indo-Aryan	Indo-Aryan	**hv:Masica:Indo-Aryan**
Kaukombaran	Kaukombaran	**hw:Zgraggen:NAdelbert**
Nusoish	Nusoish	**hvw:Lama:Nisoic**:157
Kru	Kru	**hv:Marchese:Kru:1989** **hv:Zogbo:Kru**
Southeast Borneo Malay	Southeast Borneo Malay	**hv:Collins:Malay-Borneo**
Ndu	Ndu	**hvs:Laycock:Ndu**:181, 185-189 **typ:Aikhenvald:Yalaku**:242-243
West Wapei	West Wapei	**hvw:Crowther:WWapei**
dkr	dkr	**ld:Spitzack:Kuijau**
Ningil-Yil	Ningil-Yil	**hv:Laycock:Torricelli**:768
vum	vum	**hv:Bastinetal:Bantu**:200
kjo	kjo	**h:Saxena:Introduction**
kjm	kjm	**hsoc:Proschan:Laos-Vietnam** **hv:Sidwell:Khmuic**:49
Kham-Hor	Kham-Hor	**hv:Tournadre:Tibetic**
NOCODE_Dhudhuroa	NOCODE_Dhudhuroa	**hvw:Waferetal:New-South-Wales**
dkk	dkk	**socdial:StrommeValkama:Mandar**
Southwest Pama	Southwest Pama	**hv:Black:Cape-York**
Bodo-Garo	Bodo-Garo	**hv:Burling:Bodo-Garo** **hv:Wood:Proto-Boro-Garo**
Gua-Cherepon	Gua-Cherepon	**hv:Snider:Proto-Guang:Consonants**
Makua-Lomwe	Makua-Lomwe	**hv:Kisseberth:Makhuwa**
NOCODE_Nasvang	NOCODE_Nasvang	**hvb:LynchCrowley:Vanuatu**:75
Pearic	Pearic	**hv:Sidwell:Austroasiatic** **hv:Ferlus:Pearic**
Angkuic	Angkuic	**hv:Hsiu:Angkuic**
Southwestern Tai	Southwestern Tai	**hv:EdmondsonSolnit:Kadai-Tai:Introduction**
NOCODE_Khorasan-Arabic	NOCODE_Khorasan-Arabic	**s:Dahlgren:Arabkhane**
Suau chain	Suau chain	**hvw:Cooper:Suau**
Biaoic	Biaoic	**w:Hsiu:Biao**
Palaungic	Palaungic	**hvw:Sidwell:Palaungic**:12
Nobiin Nubian	Nobiin Nubian	**sv:Bechhaus-Gerst:Nobiin**
Berber	Berber	Lameen Souag p.c.~2011 and **hv:Kossmann:Proto-Berbere**:30-31, 35-36
Gbe	Gbe	**hv:Kluge:Gbe**
Great Lakes Bantu	Great Lakes Bantu	**hvw:Schoenbrun:Great-Lakes-Bantu**, **hv:Schoenbrun:Great-Lakes-Bantu:1994**
Nuclear Maimai	Nuclear Maimai	**hsoc:Hutchinson:Heyoetc**:130 **hvw:Laycock:Lumi**:48
Mazatecan	Mazatecan	**hvwphon:Kirk:Mazatec** **hv:Leonard:Mazateco**
Koto-Olrat-Lakon	Koto-Olrat-Lakon	**hv:KalyanFrancois:Freeing**
South_Bird's_Head_Family	South Bird's Head Family	**hvtyp:BerryBerry:SBH**
bml	bml	**s:Mangulu:Lobala**:89-90
Supyiric	Supyiric	**g:Garber:Senufo-Sucite**
Kartvelian	Kartvelian	**hv:Boeder:Kartvelian**
Mairasi	Mairasi	**hv:Peckham:Etna**
Manda-Ngoni	Manda-Ngoni	**hv:Nurse:SWTanzania**:92
Lingala-Bangala	Lingala-Bangala	**g:Meeuwis:Lingala**:11-22
Lushootseed-Puget	Lushootseed-Puget	**d:Batesetal:Lushootseed**:i-xiii
eit	eit	**hvw:Laycock:Lumi**:41 and recent data collected by Matthew Dryer suggests that Eitiep is Kombioic language
Na-Togo	Na-Togo	**hv:Blench:Central-Togo**
Eastern_Jebel	Eastern Jebel	**hvw:Bender:EJebel**
Chepangic	Chepangic	**vw:Caughley:Bujheli-Chepang**
Shifted Western Romance	Shifted Western Romance	**hv:Agard:Romance**:83-90
Yarawata-Parawen-Ukuriguma	Yarawata-Parawen-Ukuriguma	**hb:Zgraggen:Madang**:23
Koman	Koman	**hv:Bender:Koman:2007**
Balto-Slavic	Balto-Slavic	**hv:Kortlandt:Balto-Slavica**
mqc	mqc	**hv:GrimesGrimes:NMoluccas**
mqk	mqk	**hv:Burton:East-Mindanao-Manobo**:21
Southern Vanuatu	Southern Vanuatu	**hv:Lynch:Southern-Vanuatu**
mql	mql	**soc:HatfieldMcHenry:Mbelime**
Wiradhuric	Wiradhuric	**hvw:Waferetal:New-South-Wales** **hv:BowernAtkinson:Pama-Nyungan**
Idomoid	Idomoid	**hvw:Armstrong:Idomoid** **hv:Armstrong:Idomoid:1989**
pap	pap	**v:Jacobs:Papiamentu**
paq	paq	**st:Oranskij:Parya**
pat	pat	**hvsoc:SchoolingSchooling:Manus**
Maran	Maran	**hv:Harvey:Warndarrang-Marra**
nns	nns	**w:Blench:Ningye**
Chokwe-Ngangela-Nyemba (K.20)	Chokwe-Ngangela-Nyemba (K.20)	**hv:Fleisch:Ngengela-Nyemba**
Asmat	Asmat	**hvw:Voorhoeve:Asmat**
Ngero	Ngero	**hv:Ross:Northwest-New-Britain:2014**
Benue-Congo Plateau	Benue-Congo Plateau	**hv:Gerhardt:Plateau**
pal	pal	**s:Sundermann:Mittelpersisch**
Maxakalian	Maxakalian	**hv:Loukotka:SAmerica**:68-71
Huastecan Mayan	Huastecan Mayan	**hvwphon:Norcliffe:Huastecan**
Flores Barat	Flores Barat	**hv:Fernandez:Flores**
NOCODE_Chairel	NOCODE_Chairel	**hv:Benedict:Sino-Tibetan**:6-7
Dagaaric	Dagaaric	**s:Kropp:Dagaare**
New South Wales Pama-Nyungan	New South Wales Pama-Nyungan	**hv:BowernAtkinson:Pama-Nyungan**
Temne-Baga	Temne-Baga	**hvs:Wilson:Atlantic**
Suki-Gogodala	Suki-Gogodala	**hv:Voorhoeve:Suki-Gogodala**
Kalkatungic	Kalkatungic	**hv:BowernAtkinson:Pama-Nyungan** **g:Blake:Kalkatungu**:117-150 **hvtyp:Dixon:Australian**:86-87
ccp	ccp	**hvw:Grierson:5:I**
ccd	ccd	**soc:CunhaNemi:Cafundo**
South Bauchi East	South Bauchi East	**hvw:Shimizu:SBauchi**
Iwaidjan_Proper	Iwaidjan Proper	**hv:Mailhammer:Iwaidjan**
Eastern Great Lakes Algonquian	Eastern Great Lakes Algonquian	**hv:Goddard:Algonquian**
nao	nao	**hv:Bielmeier:Himalayas**:108-109
gda	gda	**g:Sharma:Gade-Lohar**:10
Ju-Kung	Ju-Kung	**hv:Sands:Juu**
Khiamniungic	Khiamniungic	**he:Saul:Naga-Burma**
Nisoid	Nisoid	**hvw:Lama:Nisoic**
Chapacuran	Chapacuran	**hv:Birchalletal:Chapacuran**
Northeast Coastal Bantu	Northeast Coastal Bantu	**hv:Nurse:EBantu**
Hawu-Dhao	Hawu-Dhao	**hv:Grimes:Hawu-Dhao**
Kannadoid	Kannadoid	**hvlde:Zvelebil:Nilagiri**
North Kotoko-Buduma-Musgum	North Kotoko-Buduma-Musgum	**hv:Gravina:Central-Chadic**:46-47
Koro-Holon	Koro-Holon	**hv:PostBlench:Siangic**
NOCODE_Coeruna	NOCODE_Coeruna	**hv:Loukotka:SAmerica**:187-189
amo	amo	**h:Blench:East-Kainji** **hvw:Shimizu:Jos**
Lamaholotic	Lamaholotic	**hvw:Keraf:Lamalera**
ama	ama	**w:NimuendajuUnkel:Geral**
mow	mow	**h:Jacquot:Congo-Brazzaville**
amg	amg	**vtyp:Mailhammer:Iwaidjan**
Lahaulic	Lahaulic	**hvw:Widmer:West-Himalayish**
Uralic	Uralic	**hv:Salminen:Uralic**
psu	psu	**st:Woolner:Prakrit**
Central-East Sumbanese	Central-East Sumbanese	**hv:Asplund:Sumba**
dsi	dsi	**h:TuckerBryan:Non-Bantu-NEAfrica:1956**:19
Southern New Caledonian	Southern New Caledonian	**hbld:Haudricourt:New-Caledonia-Loyalty**
NOCODE_Amam	NOCODE_Amam	**s:AkiPennington:Amam**
wbq	wbq	**hvwld:Grierson:4**
gju	gju	**v:Sharma:Gojri**
Western Berber	Western Berber	**v:Souag:Western-Berber-Kwarandzyey**
gjk	gjk	**g:Woodland:Kachi-Gujerati**
wbl	wbl	**hv:Wendtland:Pamir**
Southern Bantu-Makua	Southern Bantu-Makua	**hv:Janson:SBantu**
Ram	Ram	**hvw:Laycock:Lumi**:48
tvy	tvy	**s:Baxter:Bidau**
Wewewa-Laboya	Wewewa-Laboya	**hv:Asplund:Sumba**
tvt	tvt	**hb:Matisoff:Tibeto-Burman**
Greater Bangi-Ntomba	Greater Bangi-Ntomba	**hv:Bastinetal:Bantu**:205-206
kvb	kvb	**hvw:Anderbeck:Batanghari**
East Nyanza	East Nyanza	**hvw:Schoenbrun:Great-Lakes-Bantu**, **hv:Schoenbrun:Great-Lakes-Bantu:1994**
kmg	kmg	**hvw:McElhanon:Huon**:7
kme	kme	**he:Ardener:Coastal-Cameroons**
Kim-Besme-Goundo	Kim-Besme-Goundo	**w:Roberts:Goundo**
Sau-Angal-Kewa	Sau-Angal-Kewa	**hvtyp:Franklin:Kewa**
kma	kma	**g:Cahill:Konni**
Subanen	Subanen	**hv:Lobel:Subanen**
Mek	Mek	**hvw:Heeschen:Mek:1978** **hvld:Heeschen:Mek:1992**
gvs	gvs	**v:Ross:Gumawana**
Ometo	Ometo	**hv:Amha:Ometo**
dde	dde	**e:Even:Badondos**
Latinic	Latinic	**vld:Baldi:Latin**
Yuin-Kuri	Yuin-Kuri	**hv:BowernAtkinson:Pama-Nyungan**
Gahuku	Gahuku	**d:Deibler:Alekano**
nmr	nmr	**hw:Strumpell:Adamauas** **hvw:Boyd:Adamawa:1988**
nmp	nmp	**hv:Bowern:Nyulnyulan-Jigsaw**
tdl	tdl	**w:Blench:Sur**
tdb	tdb	**hvw:Grierson:5:II**
nmo	nmo	**hv:Bradley:Tibeto-Burman**:89-90
tdq	tdq	**h:Williamson:Benue-Congo**
nmk	nmk	**g:Sperlich:Namakir**:21-24
nmh	nmh	**typ:BarehWar:Monsang**:200
nmi	nmi	**s:Andreasetal:Nyam**
dza	dza	**ld:BlenchNengel:Tunzu**
xns	xns	**hvw:Widmer:West-Himalayish**
Mixtepec-Quioquitani-Quier√≠ Zapotec	Mixtepec-Quioquitani-Quier√≠ Zapotec	**s:Hunnetal:Mixtepec-Zapotec**:4
srk	srk	**hv:Lobel:Southwest-Sabah**:399-401
dzn	dzn	**hv:HackettvanBulck:ETeam**:73-74 **h:Mangulu:Riverains**:12
xna	xna	**s:MacDonald:Ancient-North-Arabian**
Kanyara	Kanyara	**hv:Austin:SPilbara** **hv:BowernAtkinson:Pama-Nyungan**
kvr	kvr	**v:Kurniatietal:Tapan**
Macro-Tani	Macro-Tani	**hv:PostModi:Milang**
NOCODE_Hezhou	NOCODE_Hezhou	**hv:Dede:Chinese-Qinghai**
bjj	bjj	**hvwt:Grierson:9:I**
yyz	yyz	**hv:Bradley:Tibeto-Burman**:101
Highland East Cushitic	Highland East Cushitic	**hv:Hudson:HECushitic**
Pirriya-Kungkari	Pirriya-Kungkari	**h:Dixon:Australian2002**:xxxiii **s:Breen:Kungkari**:64 **hv:BowernAtkinson:Pama-Nyungan**
bba	bba	**typ:Winkelmann:Baatonum**
Lakes_Plain	Lakes Plain	**hvw:Clouse:Lakes-Plain** **hvw:Voorhoeve:Irian**
Rejang-Sajau	Rejang-Sajau	**hv:Kroeger:Sarawak** **hv:Hudson:Sarawak:1994**
bjy	bjy	**h:Dixon:Australian2002**:xxxiv
Eleman	Eleman	**hvs:Brown:Eleman:1973**
Goroka	Goroka	**hv:Foley:Papuan**:236-237 **hvw:Capell:CHighlands** **hv:Haiman:Gorokan** **hvld:Capell:SWPacific:1962**:105-128
Southeastern Benue-Congo Plateau	Southeastern Benue-Congo Plateau	**hv:Blench:Plateau:2009**
hem	hem	**g:Vandermeiren:Kiluba-Hemba**
Northeast Savanna Bantu	Northeast Savanna Bantu	**hv:NursePhilippson:Bantu**:175-176
Dualaic	Dualaic	**hvw:Ebobisse:Sawabantu**:395-404
Gusap-Mot	Gusap-Mot	**g:McElhanon:Selepet-Finisterre-Huon**:45
xgb	xgb	**hw:Delafosse:CotedIvoire**
Ngarna	Ngarna	**hv:Breen:Ngarna** **hv:BowernAtkinson:Pama-Nyungan**
rjg	rjg	**he:Verheijen:Manggarai**:16-21
Thalanyji-Burduna	Thalanyji-Burduna	**g:WMPALCDeak:Thalanyji**:15-16
Umbindhamuic	Umbindhamuic	**hv:Evans:Australia**:256-257 **sd:VerstrateRigsby:Yintyingka**:192-194
Mansoanka-Fore-Mboteni	Mansoanka-Fore-Mboteni	**hv:Pozdniakov:Atlantiques**
awv	awv	**hwsoc:Leboldetal:Lower-Digul**:4
Heiban	Heiban	**hvw:Schadeberg:Heiban**
Kwer-Kopkaka-Burumakok	Kwer-Kopkaka-Burumakok	**hvw:Wilbrink:Kopkaka**
Mbumic	Mbumic	**hv:Elders:Kebi-Benue**
Finisterre-Huon	Finisterre-Huon	**hv:Suter:Finisterre-Huon**
Southwest Grassfields	Southwest Grassfields	**hvw:Blench:Momo-Western-Momo**
Ga-Dangme	Ga-Dangme	**hv:Kropp:Ga-Dangme**
NOCODE_Pauxi	NOCODE_Pauxi	**hv:Girard:Carib**
Oti-Volta Occidental	Oti-Volta Occidental	**hv:Manessy:Oti-Volta**
Bata-Sharwa	Bata-Sharwa	**hv:Gravina:Central-Chadic**:47-48
Yimidhirr-Yalanji-Yidinic	Yimidhirr-Yalanji-Yidinic	**hv:Black:Cape-York**:262-265 **hv:BowernAtkinson:Pama-Nyungan**
yoy	yoy	**hv:Pittayaporn:Southwestern-Tai**
NOCODE_Baazem	NOCODE_Baazem	**w:Lovegren:Baazem**
Pacific Coast Athapaskan	Pacific Coast Athapaskan	**hvb:Golla:California**
hmv	hmv	**hvb:Niederer:Hmong-Mjen**:310-311
NOCODE_Siti	NOCODE_Siti	**vw:Kleinewillinghofer:Siti**
Kurdish	Kurdish	**h:Blau:Kurde**
agy	agy	**hv:Reid:Negritos:2013**:338-340
Chimbu-Wahgi	Chimbu-Wahgi	**hvld:Capell:SWPacific:1962**:105-128
Krongo-Tumtum	Krongo-Tumtum	**hv:ThelwallSchadeberg:Nuba** **hvs:Stevenson:Nuba**:107
Zenatic	Zenatic	**hv:Kossmann:Arabic-Berber**:21-24 **hv:Kossmann:Proto-Berbere**:31-32
Sonsorol-Tobi	Sonsorol-Tobi	**hvw:Quackenbush:Sonsorol-Truk**
nxi	nxi	**s:Spiss:Kingoni**
Darma-Byangsi-Chaudangsi	Darma-Byangsi-Chaudangsi	**hv:vanDriem:Himalayas** **hv:Sharma:Uttar-Pradesh**
all	all	**e:Singh:Allar**
sci	sci	**v:Paauw:SLM**
sck	sck	**g:Jordan-Horstmann:Sadani**
scf	scf	**h:Ethnologue:16**
Kamakanan	Kamakanan	**hvw:Silva:Kamaka**
pty	pty	**hlde:Menon:Dravidian** **h:Shashi:Kerala:Less-Known**
NOCODE_Nzadi	NOCODE_Nzadi	**hv:KoniBostoen:Kwilu**
zmh	zmh	**el:Tupper:Makolkol**
zmi	zmi	**s:Hendon:Ulu-Muar**
wmo	wmo	**hv:GlasgowLoving:Maprik**:8
wmn	wmn	**hbld:Haudricourt:New-Caledonia-Loyalty**
fax	fax	**g:Fink:Sierra-Gata**
Kombio-Yambes	Kombio-Yambes	**hv:GlasgowLoving:Maprik**
NOCODE_Gardiol	NOCODE_Gardiol	**s:Morosi:Valdesi-Piemonte**
Yambasa (A.60)	Yambasa (A.60)	**hvw:Paulian:Yambasa**
mpv	mpv	**w:Retsemaetal:Mungkip**
fak	fak	**hvld:Goodetal:Lower-Fungom**
fah	fah	**hw:Koops:Baissa**
fam	fam	**vw:Blench:Fam**
Hangaza-Shubi	Hangaza-Shubi	**hv:NursePhilippson:EAfrica**:55
NOCODE_Sadu	NOCODE_Sadu	**h:Bradley:Tibeto-Burman-China**
mpz	mpz	**wsoc:Nahhas:Mpi**
Njila	Njila	**hv:Vansina:West-Central-Africa**:273-283
East Seram	East Seram	**hvw:Collins:ESeram**
NOCODE_Homshetsma	NOCODE_Homshetsma	**s:Vaux:Homshetsma**
Central Pahari	Central Pahari	**gtd:Hendriksen:Himachali**
Komoic	Komoic	**s:Kutsch:Bila**:450-452
NOCODE_Shiwa	NOCODE_Shiwa	**hv:Cheucle:Makaa-Njem**:516
Morehead-Wasur	Morehead-Wasur	**hv:Dohler:Morehead** **hwld:Donohue:Wasur**
wsr	wsr	**lde:Gajdusek:Kuru** **hv:Lloyd:Angan-Neighbouring**:93
Southwest Sabahan	Southwest Sabahan	**hv:Lobel:Southwest-Sabah**
Western_Daly	Western Daly	**hs:Tryon:Daly**
Bolivia-Parana	Bolivia-Parana	**hv:Danielsen:Baure-Personal**
Ogonoid	Ogonoid	**hvtyp:BondAnderson:Ogonoid**
ten	ten	**hvw:Ortiz:Colombia**:133
Aceh-Chamic	Aceh-Chamic	**hv:Sidwell:Aceh-Chamic**
nbq	nbq	**g:Etherington:Nggem**
Jabuti	Jabuti	**hv:vanderVoort:Proto-Jabuti** **hv:Jolkesky:Proto-Je**:3-4
nbt	nbt	**hv:vanDriem:Himalayas**:489 **hvw:BlenchPost:Arunachal**
Makuric	Makuric	**typ:Shi:Makuri-Naga**
Mumuye-Yandang	Mumuye-Yandang	**hv:Anikinaetal:Mumuye-Yendang**
Karnic	Karnic	**hv:Breen:Karnic** **hv:Bowern:Karnic:2010** **hv:BowernAtkinson:Pama-Nyungan**:832-833
Yimchingric	Yimchingric	**he:Saul:Naga-Burma**
Matakam	Matakam	**hv:Gravina:Central-Chadic**:46, 49
suv	suv	**hvw:BlenchPost:Arunachal** **hv:Anderson:West-Kameng**
xoc	xoc	**h:NdimeleWilliamson:Languages-Rivers-State**
Salishan	Salishan	**hv:Campbell:1997**
Malagasic	Malagasic	**hv:Serva:Madagascar**
Southwest Cenderawasih Bay	Southwest Cenderawasih Bay	**hv:Kamholz:South-Halmahera-West-New-Guinea**:139
Eastern Tibetic	Eastern Tibetic	**hv:Tournadre:Tibetic**
qgu	qgu	**s:Donohue:Wulguru**
North-Central Atlantic	North-Central Atlantic	**hv:Segerer:Northern-Atlantic**
kzd	kzd	**v:Collins:Taliabo**
kzk	kzk	**hv:DunnRoss:Kazukuru**
Extreme Southern New Caledonian	Extreme Southern New Caledonian	**vphon:Rivierre:Sud-Nouvelle-Caledonie**
NOCODE_Amorite	NOCODE_Amorite	**ld:Streck:Amorite**
Simbu	Simbu	**hv:Tida:East-Simbu**, **hv:Tida:Simbu**
Grusi	Grusi	**hv:Manessy:Gurunsi** **hb:Kleinewillinghofer:Gurunsi**
Purubora-Ramarama	Purubora-Ramarama	**hv:EriksenVilacy:Tupian**
Border	Border	**hvld:Voorhoeve:CWTNG** **hvld:DonohueCrowther:NCNG**
vig	vig	**typ:Winkelmann:Viemo**
NOCODE_Tsixa	NOCODE_Tsixa	**ld:Fehn:Tsixa:Gestures**:148-149
Tor	Tor	**hew:Oosterwal:Tor**
NOCODE_Kilen	NOCODE_Kilen	**hv:Kazama:Hezhen:1998**
Eastern Tibeto-Kanauri	Eastern Tibeto-Kanauri	**hvw:Widmer:West-Himalayish**
vis	vis	**he:Luiz:Kerala**:253-254
NOCODE_Cosao	NOCODE_Cosao	**ld:BaiXu:Cosao**
jrt	jrt	**hv:Hoffmann:Angas-Goemai**
vit	vit	p.c. Roger Blench 2011
NOCODE_Morike	NOCODE_Morike	**vw:Fleck:Morike**
Southern Nilotic	Southern Nilotic	**hvphon:Rottland:SNilotischen**
Otomanguean	Otomanguean	**hv:Campbell:1997**
Mofuic	Mofuic	**hv:Gravina:Central-Chadic**:53-55
Romani	Romani	**hv:Matras:Romani**:14-48
ved	ved	**ld:Geiger:Vaddas**
twl	twl	**v:Borland:Shona**
twt	twt	**w:NimuendajuUnkel:Geral** **hv:RodriguesCabral:Tupian**
Eastern Omo-Tana	Eastern Omo-Tana	**hv:Tosco:Somali**
avv	avv	**hv:Michael:Tupi-Guarani**:204
Mantharta	Mantharta	**s:Austin:Mantharta**:24-25 **hv:BowernAtkinson:Pama-Nyungan** **hv:Austin:SPilbara**
Masa	Masa	**el:Melis:Ham**
Nuclear Oromo	Nuclear Oromo	**hv:Janko:Afaan-Oromo**
avs	avs	**hv:Michaeletal:Zaparoan**
luv	luv	**ld:SalmanKharusi:Lawatiyya**
klf	klf	**soc:Maassetal:Kendedje**
gqi	gqi	**hvld:Sun:Western-Sichuan**:20
East Bodish	East Bodish	**hvld:Hyslop:East-Bodish**
kll	kll	**soc:WendelWendel:Kagan-Kalagan**
jdg	jdg	**he:Hughes-Buller:Baluchistan**:189 and Agnes Korn p.c. 2015
klo	klo	p.c. Roger Blench 2011
Boma-Tiene-Mpe	Boma-Tiene-Mpe	**s:Mangulu:Ketiene** **hv:Bastinetal:Bantu**:202-203
Kajang	Kajang	**hv:Kroeger:Sarawak**:159
Minangkabauic	Minangkabauic	**v:Kurniatietal:Tapan**
def	def	**h:Lecoq:SWIran** **g:MacKinnon:Dezfuli-Shushtari**
Sarawak-Melanau-Kajang	Sarawak-Melanau-Kajang	**hv:Rensch:Central-Sarawak**
Mishmic	Mishmic	**hvw:BlenchPost:Arunachal**
kcf	kcf	**phon:Salffner:Ukaan**
Xincan	Xincan	**g:Sachse:Xinka**:48-49
Grebo	Grebo	**hsoc:JohnsonHasselbring:Grebo**
Nakh-Daghestanian	Nakh-Daghestanian	**hv:Nichols:Nakh-Dagestanian**
Kpwe	Kpwe	**g:Kuperus:Londo**:17-18 **he:Ardener:Coastal-Cameroons**
Laali-Tsaayi-Yaka	Laali-Tsaayi-Yaka	**g:Mouandza:Iyaa**:17
Apachean	Apachean	**hv:Hoijer:Apachean-Athapaskan**
Mampruli-Dagbani	Mampruli-Dagbani	**s:Naden:Kamara-Larabanga**
Central Gur	Central Gur	**hv:Manessy:Bwamu-Voltaiques**
csv	csv	**typ:Watkins:Sumtu**:79
Gondi	Gondi	**hv:Smith:Gondi** **hv:Garapati:Gondi** **hvwsoc:Beine:Gondi**
bkf	bkf	**hv:HackettvanBulck:ETeam**:84
Nuclear Polynesian	Nuclear Polynesian	**hv:Marck:Polynesian** **hv:Wilson:East-Polynesians**
NOCODE_Nouchi	NOCODE_Nouchi	**soc:Kube:Nouchi**, **ldsoc:Sande:Nouchi**
bkt	bkt	**hv:Bastinetal:Bantu**:206
NOCODE_Syriem	NOCODE_Syriem	**h:Haokip:Kuki-Chin**
Kapong	Kapong	**g:Sousa:Ingariko**:36-40
Ersuic	Ersuic	**hvw:Yu:Ersuic** **vw:Chirkova:Duoxu**
Arandic-Thura-Yura	Arandic-Thura-Yura	**hv:BowernAtkinson:Pama-Nyungan**
lhm	lhm	**hv:Bielmeier:Himalayas**:109-110
Adang-Hamap-Kabola	Adang-Hamap-Kabola	**hvw:Stokhof:Alor** **g:Haan:Adang**:5
Nuclear Palai	Nuclear Palai	**hvw:Laycock:Lumi**:48 and p.c.~Matthew Dryer
lhp	lhp	**hv:vanDriem:Himalayas**
ega	ega	**vw:Blench:Ega**
itk	itk	**s:Merzagora:Giudeo-Italiano**
Compromise Middle Pama	Compromise Middle Pama	**hvsoc:Sutton:Wik-Relationships** **hv:Black:Cape-York** **sd:VerstrateRigsby:Yintyingka**:192-194
Macro-Carolinian	Macro-Carolinian	**hvw:Quackenbush:Sonsorol-Truk**
Tibeto-Kanauri	Tibeto-Kanauri	**hv:vanDriem:Himalayas**
kft	kft	**hvwld:Grierson:11**:95-102
Marquesan	Marquesan	**hv:Walworth:Eastern-Polynesian** **hv:Marck:Polynesian**
Waja-Jen	Waja-Jen	**hv:Kleinewillinghofer:Adamawa-Gur** **v:Kleinewillinghofer:Tula**
nha	nha	**hv:Blevins:Nhanta**
itt	itt	**hv:Himes:Kalinga-Itneg**:103
Samu	Samu	**hv:Winkelmann:Samu**
Bragat-Aruop-Amol	Bragat-Aruop-Amol	**hvw:Laycock:Lumi**:48 and p.c.~Jennifer Wilson
kfp	kfp	**hv:Zide:Munda**
Kho-Bwa	Kho-Bwa	**hv:vanDriem:Himalayas**
wrm	wrm	**hv:BowernAtkinson:Pama-Nyungan**:835-836
pcw	pcw	**hv:Hoffmann:Angas-Goemai**
wrw	wrw	**g:Godman:Rimanggudinhma**:7-13 **g:Haviland:Yimidhirr**:32
pcl	pcl	**phon:Srivastava:Bahelia**
pcf	pcf	**hw:Bhattacharya:South-Kerala**
wrx	wrx	**he:Verheijen:Manggarai**:16-21
Greater Barito	Greater Barito	**hv:Blust:NBorneo**
oks	oks	**g:Atoyebi:Oko:2009**
Northwestern Sisaala	Northwestern Sisaala	**s:Moran:Isaalo**:16
Ostfriesisch-Groningisch	Ostfriesisch-Groningisch	**v:Niebaum:Ostfriesisch-Groningische**
Santalic	Santalic	**h:Prasad:Minor-Bihar** **hwsoc:Kimetal:Santali**
Aslian	Aslian	**hv:Dunnetal:Aslian**
North Guang	North Guang	**hv:Snider:Proto-Guang:Consonants**
Great_Andamanese	Great Andamanese	**hv:Manoharan:Andamanese**
Yamdena-Onin	Yamdena-Onin	**hv:Blust:CEMP**
North Borneo Malayo-Polynesian	North Borneo Malayo-Polynesian	**hv:Blust:NBorneo**
Guahiboan	Guahiboan	**hv:Adelaar:Andes**, **hvw:HuberReed:Colombia**
yno	yno	**hv:Pittayaporn:Southwestern-Tai**
Kagan-Kalagan	Kagan-Kalagan	**soc:WendelWendel:Kagan-Kalagan**
kfg	kfg	**he:Thurston:SIndia:4**:97
yng	yng	**hv:HackettvanBulck:ETeam**
yna	yna	**hel:Bradley:EAsia**:396
iff	iff	**hv:Crowley:Erromango**
Ansus-Ambai	Ansus-Ambai	**hvw:Anceaux:Yapen**:146
Kaansa-Dogose	Kaansa-Dogose	**v:Miehe:Kaansa-Dogose**
Nubian	Nubian	**hv:Bechhaus-Gerst:Nubischen**
Tangko-Nakai	Tangko-Nakai	**hwsoc:Hughes:UDigul** **hvw:Wilbrink:Kopkaka**
Morokodo-Beli	Morokodo-Beli	**hw:Evans-Pritchard:Non-Dinka**
Thebor	Thebor	**hv:Shafer:Sino-Tibetan:1955**
Katukinan	Katukinan	**hv:Adelaar:Katawixi**
kfn	kfn	**hv:DieuRenaud:Cameroun**
Northeastern Luzon	Northeastern Luzon	**hv:RobinsonLobel:Northeastern-Luzon**
Austroasiatic	Austroasiatic	**hv:Sidwell:Austroasiatic**
Greater Binanderean	Greater Binanderean	**hv:Smallhorn:Binanderean**
Japura-Colombia	Japura-Colombia	**hvw:Ramirez:Arawak**:447-474, 623-778
Nguni (S.40)	Nguni (S.40)	**hv:Ownby:Nguni**
NOCODE_Pa-Na	NOCODE_Pa-Na	**hv:Taguchi:Hmong-Mien**
Batanic	Batanic	**hv:Li:Batanic**
Central_Sudanic	Central Sudanic	**hv:BoyeldieuNougayrol:CSudanic** **hv:Boyeldieu:CSudanic:Labiovelar**
diy	diy	**ew:vanArsdale:Interior-Asmat**
asr	asr	**ld:Konow:Asuri** **hv:Zide:Munda** **hvwld:Grierson:4**
ast	ast	**hv:Agard:Aragonese-Asturo**
asy	asy	**hvw:Voorhoeve:Asmat**
mmv	mmv	**hv:Bruzzi:Tukano**
Bindalic	Bindalic	**hv:Breen:Biri**
mmk	mmk	**e:vonFurer-Haimendorf:Reddis**
mmj	mmj	**hvwld:Grierson:4**:135-146
asi	asi	**hv:Anceaux:Bomberai**
sbn	sbn	**hsoc:Rahman:Pakistan**
sbo	sbo	**hvw:Benjamin:Prehistory**
NOCODE_Qujiang-Hakka-Shibei-Shaoguan-Tuhua	NOCODE_Qujiang-Hakka-Shibei-Shaoguan-Tuhua	**vld:Chen:Tuhua**
South_Omotic	South Omotic	**hvw:Tsuge:SOmotic**
Pre-Andine Maipuran	Pre-Andine Maipuran	**hv:Michael:Kampa**
West Chadic A.2-3	West Chadic A.2-3	**hv:Newman:Chadic:1977**
Finungwan-Mamaa-Gusan	Finungwan-Mamaa-Gusan	**hv:HooleyMcElhanon:Morobe**:1073
North Dravidian	North Dravidian	**hv:Krishnamurti:Dravidian**
Japonic	Japonic	**g:Pellard:Ogami**:249-276
NOCODE_Nigilu	NOCODE_Nigilu	**soc:DyeDye:Wagu**:38
Samba Duru	Samba Duru	**hv:Kleinewillinghofer:Samba-Duru**
Kalam-Kobon	Kalam-Kobon	**sd:PawleyBulmer:Kalam**:20-23
jet	jet	**hvw:Voorhoeve:Miscellaneous**
jeu	jeu	**h:Jungraithmayr:Tchadiques**
koc	koc	**g:Leroy:Mankon:1977**:15
kod	kod	**hv:Asplund:Sumba**
Bena-Hehe	Bena-Hehe	**hv:Nurse:SWTanzania**:92
Huasteca Nahuatl	Huasteca Nahuatl	**hv:Canger:Nahuas:1988**:478-479
ncx	ncx	**hvw:Lastra:Nahuatl-Moderno**
Northern Luzon	Northern Luzon	**hv:Reid:Northern-Luzon**
Tidongic	Tidongic	**ld:Moody:Tidong**
Shughni-Yazgulami	Shughni-Yazgulami	**hv:Wendtland:Pamir**
Newaric	Newaric	**v:Turin:Thangmi** **hv:vanDriem:Mahakiranti**
aad	aad	**hv:Foley:Sepik:2013**
aaf	aaf	**hb:RamaiahReddy:Tribal-Dravidian**
aab	aab	**w:Blench:Tesu**
dtb	dtb	**ld:Spitzack:Eastern-Kadazan**
Ryukyuan	Ryukyuan	**hv:Pellard:Ryukyu**
South Bauchi West	South Bauchi West	**hvw:Shimizu:SBauchi** **typ:Caron:South-Bauchi-West**
Nek-Nuk	Nek-Nuk	**w:Retsemaetal:Mungkip**:7
dty	dty	**vwsoc:Eichentopf:Dotyali**
Kalikoic	Kalikoic	**hwsoc:WatsonBoone:Moru-Madi**:35-39
dtr	dtr	**ld:Banker:Lotud**
Tula-Waja	Tula-Waja	**hvld:Kleinewillinghofer:Adamawa**
Teraic	Teraic	**hv:Gravina:Central-Chadic**:49-50
Waura-Mehinaku	Waura-Mehinaku	**hv:Corbera:Waura-Mehinaku:2012**
bha	bha	**hvwld:Grierson:4**:640-645
bhe	bhe	**hsoc:Rahman:Pakistan**
bhd	bhd	**g:Varma:Bhalesi**
Bafia (A.50)	Bafia (A.50)	**hvw:GuarismaPaulian:Bantous**
NOCODE_Kpeego	NOCODE_Kpeego	**w:Zwernemann:Kpeego**
Madang	Madang	**hv:Pawley:Chequered-TNG** **hv:PawleyHammarstrom:TNG:2013**
bhp	bhp	**hv:Blust:Bima-Sumba**
qpp	qpp	**s:Pischel:Prakrit**
bhu	bhu	**hvw:Grierson:7**:372-376
bht	bht	**hvwt:Grierson:9:IV**
Kisi-Pangwa	Kisi-Pangwa	**hv:Nurse:SWTanzania**:92
Bolyu-Bugan	Bolyu-Bugan	**hv:Sidwell:Austroasiatic:2015**:194
mlc	mlc	**vphon:GregersonEdmondson:Cao-Lan**
Nyaturu-Nilamba	Nyaturu-Nilamba	**hvw:Masele:F**
liw	liw	**s:Arifin:Sindang**
Sogeram	Sogeram	**hv:Daniels:Sogeram:2015**
Narrow_Talodi	Narrow Talodi	**hvw:NortonAlaki:Talodi** (interpreting the significance of the innovations differently)
vnm	vnm	**g:Crowley:Naman**:18
Zandic	Zandic	**h:Boyd:Zande**
kas	kas	**hv:KoulSchmidt:Kashmiri-Shina**
South Adelbert	South Adelbert	**hv:Daniels:Sogeram:2015**
Khasi-Palaung	Khasi-Palaung	**hv:Sidwell:Khasi-Palaung**
rhg	rhg	**e:Yegar:Rohingya**
Hindko	Hindko	**hvw:Marshall:Hindko**
tpg	tpg	**hvw:Stokhof:Alor**
tpj	tpj	**g:Gonzalez:Tapiete**
Sahuan	Sahuan	**hv:GrimesGrimes:NMoluccas**:50-52
bzo	bzo	**hv:HackettvanBulck:ETeam**:73-74 **h:Mangulu:Riverains**:12
Wubuy-Anindilyakwa	Wubuy-Anindilyakwa	**g:vanEgmond:Enindhilyakwa**:314-370
cde	cde	**e:vonFurer-Haimendorf:Chenchus**:284-285
Central Dravidian	Central Dravidian	**hv:Krishnamurti:Dravidian**
mfb	mfb	**v:Nothofer:Lom**
Subcontinental Central Indo-Aryan	Subcontinental Central Indo-Aryan	**hv:Matras:Romani**:14-48 **hv:Masica:Indo-Aryan**
cdy	cdy	**s:Li:Chadong**
cdz	cdz	**hwsoc:Kimetal:Santali**
NOCODE_Athima	NOCODE_Athima	**w:Alpher:Athima**
ymr	ymr	**he:Thurston:SIndia:4**:394
NOCODE_Pallanganmiddang	NOCODE_Pallanganmiddang	**hvw:Waferetal:New-South-Wales**
Rufiji-Ruvuma	Rufiji-Ruvuma	**hv:Nurse:EBantu**
bfn	bfn	**hv:Schapperetal:Timor-Kisar**
Eastern Murutic	Eastern Murutic	**hv:Spitzack:Murutic**
ych	ych	**hel:Bradley:EAsia**:396-397
ymd	ymd	**hel:Bradley:EAsia**:364, 401
Je	Je	**hv:Jolkesky:Proto-Je**:3-4
Boleic	Boleic	**h:Schuh:Bole-Tangale:Introduction**
Yapen	Yapen	**hv:Kamholz:South-Halmahera-West-New-Guinea**:138
Paitanic	Paitanic	**hvld:King:Paitanic**
Mehek-Pahi	Mehek-Pahi	**hsoc:Hutchinson:Heyoetc**:128, 130 **hvw:Laycock:Lumi**:48
Ibanic	Ibanic	**hv:Collins:Ibanic**
stg	stg	**hv:Sidwell:Austroasiatic**:83
hif	hif	**v:Siegel:Fiji-Indians**
hii	hii	**hvwt:Grierson:9:IV**
hij	hij	**soc:Bradley:Hijuk**
Chukotko-Kamchatkan	Chukotko-Kamchatkan	**hvd:Fortescue:Chukotko-Kamchatkan**
Mondzish	Mondzish	**hvw:Lama:Nisoic**, **hvw:Hsiu:Mondzish**
Yidinic	Yidinic	**g:Patz:Djabugay**
Maninka-Mori	Maninka-Mori	**hdial:Bolingetal:Manding** **hvw:Derive:Manding-Ivoire**
Inland Gulf of Papua	Inland Gulf of Papua	**hv:UsherSuter:Anim**
Eastern Bengali	Eastern Bengali	**hvld:Chowdhury:East-Pakistan**
Surinamese Creole English	Surinamese Creole English	**hv:Smith:Creole-Surinam**
Raja Ampat-South Halmahera	Raja Ampat-South Halmahera	**hv:Kamholz:South-Halmahera-West-New-Guinea**:136-137
seq	seq	**phon:Mills:Senoufo**:xii-xx
Asas-Sinsauru	Asas-Sinsauru	**hb:Zgraggen:Madang**:13
Central Santa Isabel	Central Santa Isabel	**hv:Voica:Isabel**
arg	arg	**hv:Agard:Aragonese-Asturo**
arj	arj	**hv:Bruzzi:Tukano**
sej	sej	**hv:HooleyMcElhanon:Morobe**:1069
stu	stu	**hv:Sidwell:Austroasiatic:2015**:207
zkt	zkt	**s:Kane:Kitan**
Pomoan	Pomoan	**hv:McLendon:Pomoan:2006**
zkr	zkr	Contra **vw:Blench:Monpa** there are good arguments for considering Meyor to be a Tibetanised Mijuic language rather than vice versa **hld:Sun:Eastern-Himalayan-China** (thanks to Scott DeLancey for arguing this out with me)
ikr	ikr	**s:Sommer:Ikarranggal**
ikp	ikp	**hv:JungraithmayrGanslmayr:Westafrika**
fgr	fgr	**hvw:DoornbosBender:Wadai-Darfur**:70-75 **hvw:Boyeldieu:SBB**:21
Tangale-Kwami-Kupto	Tangale-Kwami-Kupto	**typ:Zoch:Bole-Tangale**:29
Dani	Dani	**hvw:Larson:Irian-Highlands**
ikl	ikl	**w:Blench:Kulu**
Dullay	Dullay	**hvld:Sava:Dullay**
Samoyedic	Samoyedic	**hvtyp:Janhunen:Samoyedic**
Atlas Berber	Atlas Berber	**hv:Kossmann:Proto-Berbere**:31
Kabyle-Atlas Berber	Kabyle-Atlas Berber	p.c.~Maarten Kossmann 2014
Wetar	Wetar	**hvw:Hinton:Wetar**
Borneo Malay	Borneo Malay	**vld:Collins:Kutai-Malay**
pdi	pdi	**hv:PraneeThongkum:Tai**
pdc	pdc	**s:Green:Pfalzische**
Central Kenya Bantu	Central Kenya Bantu	**hv:Nurse:EBantu**
bhi	bhi	**wsoc:Vunnamatlaetal:Nimadi**
tgt	tgt	**hv:Himes:Kalamian**
tgz	tgz	**hv:Sutton:Southern-Cape-York**
Lundu-Balong (A.10)	Lundu-Balong (A.10)	**hvw:Hedinger:Manenguba**
Maweti-Guarani	Maweti-Guarani	**hv:MeiraDrude:Maweti-Guarani**
Luvic	Luvic	**hv:Melchert:Anatolian**
Chocoan	Chocoan	**hv:AguirreLicht:Choco**
Lucumi-Yoruba	Lucumi-Yoruba	**v:Olmsted:Yoruba-Lucumi**
swk	swk	**soc:Matiki:Malawi**
Wati	Wati	**hv:BowernAtkinson:Pama-Nyungan**
Gumbaynggiric	Gumbaynggiric	**s:Crowley:Yaygir**
dub	dub	**he:Singh:Scheduled**:257
due	due	**h:Lobel:Philippine**:211-235
duy	duy	**hel:Headland:Negrito**
duz	duz	**hv:Boyd:Adamawa-Ubangi**:179
Panoan	Panoan	**hvb:Fleck:Panoan**
dup	dup	**phon:Seidlitz:Duano**
xab	xab	**w:Blench:Sambe**
Kamano-Yagaria	Kamano-Yagaria	**hvsoc:WurmLaycock:NG**
xag	xag	**ld:Greppin:Caucasian-Albanians**
Greater Awyu	Greater Awyu	**hv:deVriesetal:Greater-Awyu**
Mbugwe-Langi	Mbugwe-Langi	**hv:Nurse:EBantu**
gay	gay	**g:Eades:Gayo**
boy	boy	**hvw:McMaster:Uele**:242, 263
nrc	nrc	**hvld:EskaEvans:Continental-Celtic**
gat	gat	**lde:Gajdusek:Kuru** **hv:Lloyd:Angan-Neighbouring**:93
gar	gar	**hvld:Lithgow:Milne** **hvsoc:Lithgow:Fergusson-Normanby**
NOCODE_Batanta	NOCODE_Batanta	Untelligible but close to Ma'ya **phon:Remijsen:Raja-Ampat**:42 **phon:vanderLeeden:Gale-Maya**:83 **hvw:Cowan:Ambtelijk**
Okiek-Akie	Okiek-Akie	**hvw:Distefano:Kalenjin**:84-93 although more recent work holds this relationship as premature (p.c.~2015 Christa K√∂nig)
opk	opk	**phon:Wilbrink:Kopkaka**
Outer Nimboranic	Outer Nimboranic	**g:Anceaux:Nimboran**:2 **phon:vanderWildenvanderWilden:Kemtuk**:32
mlb	mlb	**soc:Boone:Mbule**
Southern Kra	Southern Kra	**hv:Edmondson:Kra**
Tamaic	Tamaic	**hv:Edgar:Tama** **hv:Bender:ESudanic**
mlh	mlh	**hvw:McElhanon:Huon**:7
Yalandyic	Yalandyic	**g:Patz:Yalanji**:1-6
Nuclear-Macro-Je	Nuclear Macro-J√™	**g:Ribeiro:Karaja**:262-287
mlz	mlz	**hwdial:Grino:Panay**
fum	fum	p.c. Roger Blench 2011
Hlaic	Hlaic	**hvwphon:Norquest:Proto-Hlai**
Iwam-Wogamus	Iwam-Wogamus	**hv:Foley:Sepik:2013**
Kainantu	Kainantu	**hv:McKaughan:Gadsup-Auyana-Awa-Tairora**
Kham	Kham	**g:Watters:Kham**:11-14
Burui-Gaikundi	Burui-Gaikundi	**hw:Staalsen:Sawos**:11
riu	riu	**he:Verheijen:Manggarai**:16-21 **s:Arndt:Ngada**
Mangarrayi-Maran	Mangarrayi-Maran	**hv:Sharpe:Alawa**
NOCODE_Egbuta	NOCODE_Egbuta	**s:Mangulu:Egbuta**
jpr	jpr	**s:Paul:Judeo-Persian**
NOCODE_Korapun-Bromley	NOCODE_Korapun-Bromley	**hvw:Heeschen:Mek:1978**:9 **hvw:Voorhoeve:Irian** (The recognition of the separateness from Korapun-Sela of the Korapun data of Bromley is due to Tim Usher)
psm	psm	**hv:Adelaar:Andes**:431
NOCODE_Goo	NOCODE_Goo	**ld:Vydrin:Goo**
NOCODE_Lebu	NOCODE_Lebu	**w:Angrand:Lebous**
Edoid	Edoid	**hvw:Elugbe:Edoid**
Lengua-Mascoy	Lengua-Mascoy	**hv:ManelisKleinStark:Chaco**:811-824 **hv:UnruhKalisch:Enlhet-Enenlhet**
Low German	Low German	**hv:Biesinger:Deutschen**, **h:DaanBlok:Dialecten**
Tuparic	Tuparic	**hv:VilacyFernanda:Tupari**
Northern Murutic	Northern Murutic	**hv:Spitzack:Murutic**
NOCODE_Mpra	NOCODE_Mpra	**w:Blench:Mpra**
syk	syk	**hv:Gravina:Central-Chadic**:46, 50
syi	syi	**hv:Bastinetal:Bantu**:199 **vtyp:Echegaray:Baseque**
Kohistani	Kohistani	**hvld:Bashir:Dardic**
syl	syl	**hvw:Grierson:5:I**
sys	sys	**hv:Boyeldieu:CSudanic** **hvw:DoornbosBender:Wadai-Darfur**:70-75
pse	pse	**hvw:Anderbeck:Batanghari**
Arabic	Arabic	**hv:Al-Jallad:Neo-Arabic** **hvb:Watson:Arabic-Dialects**
NOCODE_Ngala-Santandrea	NOCODE_Ngala-Santandrea	p.c.~Raymond Boyd 2011
Italo-Western Romance	Italo-Western Romance	**hv:Agard:Romance**:73-80
West Rift South Cushitic	West Rift South Cushitic	**hv:KiesslingMous:WRift**
kni	kni	**w:Blench:Anib**
Tangkic	Tangkic	**hv:Evans:Tangkic:2005** **hvw:Evans:Minkin**
East Chadic A.3	East Chadic A.3	**hb:BarreteauNewman:Tchadiques**
East Chadic A.2	East Chadic A.2	**hv:Jungraithmayr:Nachtigal**
East Chadic A.1	East Chadic A.1	**hv:Jungraithmayr:Nachtigal**
boe	boe	**hvld:Goodetal:Lower-Fungom**
knz	knz	**hb:Kleinewillinghofer:Gurunsi**:44-45
NOCODE_Older-Runic	NOCODE_Older-Runic	**st:Antonsen:Older-Runic**:26
jbn	jbn	**hv:Kossmann:Arabic-Berber**:25
Margi-Mandara-Mofu	Margi-Mandara-Mofu	**hv:Gravina:Central-Chadic**:46
Buru-Sula-Taliabo	Buru-Sula-Taliabo	**hv:Collins:WCMaluku** note that the innovations support Bula-Suru rather than Sula-Taliabo
ldd	ldd	**w:Caron:Luri**
Vitiaz linkage	Vitiaz linkage	**hv:Ross:WMelanesia**:160-173
ldq	ldq	**hvtyp:Prischnegg:Yukuben**
Sydney-Hawkesbury	Sydney-Hawkesbury	**hvw:Waferetal:New-South-Wales**
West Chadic B.2	West Chadic B.2	**hvw:Skinner:NBauchi**
West Chadic B.1	West Chadic B.1	**hvw:Schuh:Shira**
hji	hji	**wsoc:Anderbeck:Haji**
NOCODE_Anauya	NOCODE_Anauya	**hvw:Ramirez:Arawak**:475-498 (little in the way of forms exclusively shared with Yabaana so the two are not subgrouped here)
cuu	cuu	**hv:Pittayaporn:Southwestern-Tai**
Tipperic	Tipperic	**wsoc:Kimetal:Tripura**
Stieng	Stieng	**typ:Owen:Stieng**:7-9
Raja Ampat Maya	Raja Ampat Maya	**hv:Kamholz:South-Halmahera-West-New-Guinea**:96 **phon:Remijsen:Raja-Ampat**
Elip-Maala	Elip-Maala	**hvwphon:Bebine:Yambassa**
cua	cua	**hv:Sidwell:Cua-EBahnaric**
NOCODE_Jumana	NOCODE_Jumana	**hvw:Ramirez:Arawak**:435-446
Sira (B.40)	Sira (B.40)	**hv:Bastinetal:Bantu**:200
cuj	cuj	**he:Huertas:Peruvian-Isolation**:48
rgn	rgn	**sv:Michelotti:Sammarinese**
Kwambi-Ndonga	Kwambi-Ndonga	**ld:Fourie:Kwambi**
Aymaran	Aymaran	**hv:Adelaar:Andes**
bix	bix	**phon:Sahu:Brijia**
biy	biy	**ew:Roy:Birhors**
Oscan-Umbrian	Oscan-Umbrian	**vld:Baldi:Latin**:174-180
biw	biw	**g:Henson:Kol**
bit	bit	**hvw:Dyeetal:Sepik-Hill**
Saliban	Saliban	**vw:Hammarstrom:Maco**, **hv:Estrada:Saliba-Piaroa**
Pauwasi	Pauwasi	**hvw:Voorhoeve:Miscellaneous**
Kayagaric	Kayagaric	**hvw:Voorhoeve:Miscellaneous**:87-88
ljx	ljx	**hel:Wurm:Pacific**:557
Tuareg	Tuareg	**hv:Kossmann:Proto-Berbere**:31
Wantoat-Awara	Wantoat-Awara	**hv:HooleyMcElhanon:Morobe**:1074
eee	eee	**vld:Edmondson:E**
Ainu	Ainu	**hv:Vovin:Proto-Ainu:1993**
Lamang-Hdi	Lamang-Hdi	**hv:Gravina:Central-Chadic**:56
Arapesh	Arapesh	**g:Nekitel:Abu**:39
North Mangyan	North Mangyan	**hv:Zorc:Mangyan** **hv:Blust:CPhilippines**
Kosorong-Burum-Mindik	Kosorong-Burum-Mindik	**hv:HooleyMcElhanon:Morobe**:1070
Desert Nyungic	Desert Nyungic	**hv:BowernAtkinson:Pama-Nyungan**
Sawosic	Sawosic	**hw:Staalsen:Sawos**:11
NOCODE_Samatu	NOCODE_Samatu	**hel:Bradley:EAsia**:399
Vehicular Malay	Vehicular Malay	**hs:Paauw:Malay**
pez	pez	**s:Sercombe:Eastern-Penan**
pev	pev	**typ:Mattei-Muller:Pemono**
pel	pel	**hvw:Anderbeck:Batanghari**
Kawesqar	Kawesqar	**hv:ViegasBarros:Qawasqar**
Delawaran	Delawaran	**ld:Goddard:Mahican**
pea	pea	**ldt:Oetomo:Pasuruan**
Epi-Efate	Epi-Efate	**hv:Lynch:Efate-Erromango**
Halbic	Halbic	**v:Bhattacharya:Halbi-Bhatri**
aho	aho	**hv:EdmondsonSolnit:Kadai-Tai:Introduction**
Tarokoid	Tarokoid	**hvw:Blench:Tarokoid**
rub	rub	**hvw:Schoenbrun:Great-Lakes-Bantu**, **hv:Schoenbrun:Great-Lakes-Bantu:1994**
ruc	ruc	**h:Ladefogedetal:Uganda**
Epi	Epi	**hvtyp:Tryon:Epi**
Pagi-Kilmeri	Pagi-Kilmeri	**g:Gerstner-Link:Kilmeri** **h:Brown:Pagi-Kilmeri**:195
Cangin	Cangin	**hvw:Williams:Cangin**
bgc	bgc	**hvwt:Grierson:9:I**
Yaben-Bilakura	Yaben-Bilakura	**hb:Zgraggen:Madang**:23
Nupoid	Nupoid	**hvw:Blench:Nupoid**
bgk	bgk	**hsoc:Proschan:Laos-Vietnam** **hv:Sidwell:Khmuic**:49
bgq	bgq	**hvwt:Grierson:9:II**
bgx	bgx	**ld:Manevic:Juruka**
bgy	bgy	**hv:Collins:Maluku**
ylm	ylm	**hv:Bradley:Tibeto-Burman**:104
Gorontalic	Gorontalic	**hv:SneddonUsup:Gorontalic**
Inoric	Inoric	**vwsoc:Ahland:Mesmes**:98-103
nsf	nsf	**hv:Yang:Nisu**
Nuclear Nicobaric	Nuclear Nicobaric	**hv:Sidwell:Austroasiatic:2015**:199
nsx	nsx	**ld:Pires:Songo**
nsy	nsy	**vw:AnderbeckAprilani:Nasal**
enc	enc	**hv:Edmondson:Kra**
Kilivilic	Kilivilic	**hvld:Lithgow:Milne**
New Caledonian	New Caledonian	**hv:Rivierre:Nouvelle-Caledonie**
Yuat	Yuat	**hv:Laycock:Sepik**, **hv:Foley:Sepik:2013**
wgy	wgy	**hv:Dixon:Cairns** **g:Dixon:Wargamay** **h:Dixon:Australian2002**:xxv, xxxiii
mkb	mkb	**s:Dasgupta:Mal-Pahariya**
mka	mka	**vld:Boukari:Pre**
xpc	xpc	**ld:Voros:Pecheneg**
xpg	xpg	**s:Brixhe:Phrygian**:72
njj	njj	**wsoc:FloraBrye:Njen** **hvtyp:Stallcup:Moghamo-Ngie-Oshie**
xps	xps	**hv:Melchert:Anatolia**:2157-2158
Gauda-Kamrupa	Gauda-Kamrupa	**hvw:Toulmin:Bangla**
East_Bird's_Head	East Bird's Head	**g:Gravelle:Moskona**
Tumbuka-Senga	Tumbuka-Senga	**hv:Bastinetal:Bantu**:220
kdg	kdg	**he:Whiteley:Northern-Rhodesia**
pwr	pwr	**hvw:Grierson:6**:174
sdr	sdr	**e:DasRaja:Oraons**
sds	sds	**stw:Provotelle:Sened** and p.c.~Maarten Kossmann 2014
NOCODE_Bonari	NOCODE_Bonari	**hv:Girard:Carib**:116-117
aqz	aqz	**hv:AragonCabral:Akuntsu**
Northwest Sumatra-Barrier Islands	Northwest Sumatra-Barrier Islands	**hv:Nothofer:Barrier-Sulawesi-Philippines** **hv:Nothofer:Barrier**
wnp	wnp	Wanap shows lexicostatistical figures suggestive of a subgrouping with Palai and/or West Palai languages but since the elevated figures are only with immediately adjacent languages of those groups the explanation is probably borrowing rather than subgrouping.
Sayhadic	Sayhadic	**hv:Stein:Ancient-South-Arabian**
sdc	sdc	**s:Jones:Sardinian**:314
aqn	aqn	**hv:Reid:Negritos:2013**:338-340
Dumpas-Sukang	Dumpas-Sukang	**hv:Lobel:Southwest-Sabah**:396-398
Iroquoian	Iroquoian	**hv:Julian:Iroquoian**
Greater Luyia	Greater Luyia	**hv:Mould:Greater-Luyia**
Cariban	Cariban	**hv:Meira:Cariban:2006**, **hewsoc:Howard:Waiwai**, **hv:Gildea:Cariban**
sxb	sxb	**vld:Rottland:Suba**
North Bahnaric	North Bahnaric	**hv:Edmondsonetal:North-Bahnaric**
Yalic	Yalic	**g:Fahner:Yali**:3
Northern Malakula	Northern Malakula	**hv:LynchBrotchie:Tirax** **hv:Lynch:Northern-Malakula**
Nyo	Nyo	**hv:Kropp:Kwa** **hv:Stewart:Kwa**
Kulin	Kulin	**hv:Blake:Kulin**
nad	nad	**v:OGradyLaughren:Palyku**
naj	naj	**hv:Pozdniakov:Atlantiques**
grz	grz	**hel:Wurm:Pacific**:493
ext	ext	**s:Curiel:Extremeno**
Membi-Mangbutu-Efe	Membi-Mangbutu-Efe	**hwb:Bokula:Irumu:Moru-Mangbetu**:226-234
NOCODE_Njanga	NOCODE_Njanga	**el:Connell:Nigeria-Cameroon**:213
Teun-Nila-Serua	Teun-Nila-Serua	**hvw:Taber:SWMaluku**
Kalapuyan	Kalapuyan	**h:Mithun:NAmerica**:431-433
NOCODE_Yao	NOCODE_Yao	**hv:Girard:Carib**
Indo-Aryan Eastern zone	Indo-Aryan Eastern zone	**hv:Masica:Indo-Aryan**
Bwile-Bemba	Bwile-Bemba	**hv:Bastinetal:Bantu**
Tungusic	Tungusic	**hv:Whaley:Tungusic**
Kewa-Huli	Kewa-Huli	**hv:Franklin:Engan-Pronouns**
svm	svm	**ld:Breu:Moliseslavische**
NOCODE_Nterato	NOCODE_Nterato	**hew:Goody:Guang** **h:Kropp:Vanishing-Ghana**
agf	agf	**hv:Kamholz:South-Halmahera-West-New-Guinea**:158-244
Southeastern Ngwi	Southeastern Ngwi	**hvsoc:Pelkey:Phula**
Konkanic	Konkanic	**hvw:Grierson:7**
Mel	Mel	**hv:Pozdniakov:Atlantiques**
agv	agv	**hv:Reid:Negritos:2013**:340-341
B10-B30	B10-B30	**hv:Mouguiama-DaoudavanderVeen:B10B30**
Indo-Portuguesic	Indo-Portuguesic	**hvw:Clements:Indo-Portuguese**
South Peripheral Kuki-Chin	South Peripheral Kuki-Chin	**g:Hartmann:Daai-Chin**:25-26
East Timor	East Timor	**hvphon:Mandala:Oirata** **hv:vanNaerssen:East-Timorese**
Yokutsan	Yokutsan	**hvb:Golla:California**
bvv	bvv	**w:Zamponi:Avane**
bvu	bvu	**ld:Collins:Bukit**
bvt	bvt	**hv:LoskiLoski:ESeram**
Kowan	Kowan	**hv:Zgraggen:Madang:1971**
bvy	bvy	**s:Rubino:Utudnon**
Southeast Choiseul	Southeast Choiseul	**s:Ross:Sisiqa**:456
bvb	bvb	**hv:Grollemund:Bantu-Nord-Ouest** **hv:Vansina:Western-Bantu**
Western Lega	Western Lega	**h:Biebuyck:Lega** **s:Botne:Lega**:422-423
Kamengic	Kamengic	**hvw:BlenchPost:Arunachal** **hv:Anderson:West-Kameng**
bvh	bvh	**el:Haruna:Bubbure**
Bura-Marghi	Bura-Marghi	**hv:Gravina:Central-Chadic**:50-51
lkl	lkl	**hsoc:Cooper:Belietc**:153
Momare-Migabac	Momare-Migabac	**hv:HooleyMcElhanon:Morobe**:1070
lkj	lkj	**soc:Cullip:Remun**
lki	lki	**hvw:Anonby:Luri**
Muller-Schwaner Punan	Muller-Schwaner Punan	**hvld:SellatoSoriente:Muller**
lke	lke	**h:Ladefogedetal:Uganda**:71
lkc	lkc	**hv:Bradley:Tibeto-Burman**:104
Yau-Yis	Yau-Yis	**hv:Laycock:Torricelli**:768
Otomi	Otomi	**hevw:Lastra:Otomies**
Central-Western Yapen	Central-Western Yapen	**hv:Kamholz:South-Halmahera-West-New-Guinea**:138-139
Barbacoan	Barbacoan	**hv:Adelaar:Andes**:141-151
Anus-Podena	Anus-Podena	**hwsoc:LeeSawi:Sobei**
Awyu	Awyu	**hwsoc:KriensLebold:Wildeman**:26
West Ibero-Romance	West Ibero-Romance	**hv:Agard:Romance**:99-106
Caddoan	Caddoan	**hvw:Parks:Northern-Caddoan**
Peripheral Western Malakula	Peripheral Western Malakula	**hv:Lynch:Vowel-Malakula**
rie	rie	**h:Schliesinger:Laos**
South Dravidian	South Dravidian	**hv:Krishnamurti:Dravidian**
Kadaic	Kadaic	**hv:Ostapirat:Proto-Kra**
kcs	kcs	**hv:Hoffmann:Angas-Goemai**
trh	trh	**wsoc:Troolin:Turaka**
trj	trj	**hw:Alio:Kajakse**
trm	trm	**hvw:Morgenstierne:Nuristan**:120
Gorontalo-Mongondow	Gorontalo-Mongondow	**hvw:Usup:Gorontalo-Mongondow**
NOCODE_Apolista	NOCODE_Apolista	**vw:Payne:Apolista**
Hagen	Hagen	**hvld:Capell:SWPacific:1962**:105-128 **hv:Shafer:NG**:370-372
trd	trd	**w:Osada:Turi**
bxv	bxv	**hvw:Caprile:Sara-Bongo-Baguirmiens**
bxi	bxi	**w:Austin:Pirlatapa**
bxl	bxl	**w:Kastenholz:Jeri-Kuo**
Zaza-Gorani	Zaza-Gorani	**h:Blau:Gurani-Zaza**
bxc	bxc	**hb:Echegaray:Guineos**
Sawabantu	Sawabantu	**hvw:Meinhof:Kamerun** **hv:NursePhilippson:Bantu** **hv:Klieman:Gabon**
Indo-European	Indo-European	**hv:Clackson:Indo-European**
odk	odk	**hvwld:Grierson:11**
ues	ues	**hv:vandenBerg:Munic**
Kadazan-Dusun	Kadazan-Dusun	**hdialsoc:BankerBanker:Kadazan-Dusun**
Outer Enga	Outer Enga	**hvw:ConradLewis:USepik** **hvw:DaviesComrie:Yuat**:281 **e:Dornstreich:Gadio-Enga**
Makaa-Njem (A.80)	Makaa-Njem (A.80)	**hv:Bastinetal:Bantu**:198
Dogon	Dogon	**hw:Hochstetler:Dogon**, **hv:HeathProkhorov:Dogon** **hv:MoranProkic:Dogon**
Mpiemo-Ukhwejo	Mpiemo-Ukhwejo	**phon:Festen:Mpyemo**
Hyenghene	Hyenghene	**hbld:Haudricourt:New-Caledonia-Loyalty**
ycp	ycp	**hel:Bradley:EAsia**:364, 401
Mirndi	Mirndi	**hv:Harvey:Mirndi**
Nuclear_Torricelli	Nuclear Torricelli	**hv:Laycock:Torricelli**
bdu	bdu	**s:Che:Oroko**
bdv	bdv	**e:Ramadas:Porajas**
Alto Negro	Alto Negro	**hvw:Ramirez:Arawak**:475-498
Lowland Ok	Lowland Ok	**hvw:Healey:Ok**
Kalamic-South Adelbert	Kalamic-South Adelbert	**sd:PawleyBulmer:Kalam**:23
Angami-Ao	Angami-Ao	**hv:Coupe:Overcounting-Nagaland**
NOCODE_Akpondu	NOCODE_Akpondu	**ld:Blench:Akpondu**
Paniai Lakes	Paniai Lakes	**s:Moxness:Auye**:6-7
leo	leo	**s:BiloaKatamba:Tuki**:10
Spiti-Jad	Spiti-Jad	**hv:vanDriem:Himalayas**:856
Greek	Greek	**hv:Browning:Greek**
Himachali	Himachali	**gtd:Hendriksen:Himachali**
Dakoid	Dakoid	**vw:Blench:Dong**
Macleay-New England	Macleay-New England	**hvw:Waferetal:New-South-Wales**
ctt	ctt	**he:Francis:Nilgiris**:158
Timoric A	Timoric A	**hvw:Hull:Timor:Austronesian**
Timoric B	Timoric B	**hvw:Hull:Timor:Austronesian**
Katla-Tima	Katla-Tima	**hvs:Stevenson:Nuba**
Kadugli-Krongo	Kadugli-Krongo	**hv:Dafalla:Katcha-Kadugli** **hv:ThelwallSchadeberg:Nuba**
ctg	ctg	**hvw:Grierson:5:I**
Malayo-Polynesian	Malayo-Polynesian	**hv:Pawley:Filipinos** **hv:Ross:Batanic** **hv:Adelaar:Austronesian-Asia-Madagascar**
rdb	rdb	**s:Lazard:Rudbar**
Maban	Maban	**hv:Edgar:Maba** **hv:Starostin:Mimi**
ctn	ctn	**typ:Bickeletal:Chintang-Belhare**
NOCODE_Faeto-Celle-San-Vito-Francoprovencal	NOCODE_Faeto-Celle-San-Vito-Francoprovencal	**g:Kattenbusch:Frankoprovenzalische**
Tacanan	Tacanan	**hv:Loukotka:SAmerica**, **hv:Guillaume:Motion-Tacanan**
Oriya-Gauda-Kamrupa	Oriya-Gauda-Kamrupa	**hvw:Toulmin:Bangla**
sgu	sgu	**hv:Collins:Maluku**
wii	wii	**hvw:Laycock:Lumi**:48
Duun-Seenku	Duun-Seenku	**hvtyp:Kastenholz:Samogo**:92-93, 100
sgm	sgm	**hw:Johnston:Uganda:2**
sgl	sgl	**hv:Wendtland:Pamir**
Western Malayic Dayak	Western Malayic Dayak	**w:Hudson:Selako** **hv:Ross:Malayic** **std:Adelaar:Salako** **v:Adelaar:Belangin**
Mbam	Mbam	**hv:MousBreedveld:Bantu-A40-A60**
chn	chn	**g:Robertson:Chinuk-Wawa**
Tarahumaran	Tarahumaran	**h:Caballero:Tarahumara**
Axioid	Axioid	**hvw:Lama:Nisoic**:151-153
Ngbandic	Ngbandic	**h:BoyeldieuDiki-Kidiri:Ngbandi-Sango-Kpatiri**
zil	zil	**g:Babaev:Zialo**
Papuan Tip linkage	Papuan Tip linkage	**hv:Ross:WMelanesia**:190-212
Buyu-Holoholo	Buyu-Holoholo	**hv:Bastinetal:Bantu**:210
NOCODE_Ooku	NOCODE_Ooku	**hw:Ray:ESEPapua**
South-West Pama-Nyungan	South-West Pama-Nyungan	**hv:Koch:Methodological**
Chinookan	Chinookan	**dial:Hymes:Clackamas**:365
Nambiquaran	Nambiquaran	**g:Eberhard:Mamainde**:21-31
Yuruna	Yuruna	**hv:FargettiRodrigues:Xipaya-Juruna**
Luban	Luban	**hv:Ahmed:East-Central-Africa** **hv:Bastinetal:Bantu**:218
Moru-Madi	Moru-Madi	**hwsoc:WatsonBoone:Moru-Madi**
srg	srg	**e:Jocano:Sulod**
Mbala-Holu-Sondi (K.10)	Mbala-Holu-Sondi (K.10)	**hv:Vansina:West-Central-Africa**:273-283 **hv:Bastinetal:Bantu**
Central Eastern Aramaic	Central Eastern Aramaic	**hv:Kim:Modern-Aramaic**
Bosavi	Bosavi	**hvw:Shaw:Bosavi**
Narrow Bantu	Narrow Bantu	**hv:BostoenGregoire:Bantoue**
NOCODE_Wagu	NOCODE_Wagu	**soc:DyeDye:Wagu**:38
NOCODE_Tiverighotto	NOCODE_Tiverighotto	**hv:Girard:Carib**
Southeast Santo	Southeast Santo	**hvb:LynchCrowley:Vanuatu**:56-57
Corridor Bantu	Corridor Bantu	**hv:WalshSwilla:Corridor**
NOCODE_Basum	NOCODE_Basum	**hv:Tournadre:Tibetic**
Upper Guinea Portuguese	Upper Guinea Portuguese	**hv:Ferraz:WAfrica**
afo	afo	**hv:Blench:Plateau:2009**
Manobo	Manobo	**hv:Elkins:Proto-Manobo**
sif	sif	**hv:Zogbo:Kru**
Ni-Li-Kazhouish	Ni-Li-Kazhouish	**hvw:Lama:Nisoic**:175-177 no exclusive innovations for Nisoid and Lisoid are cited
Serui-Busami	Serui-Busami	**hvw:Anceaux:Yapen**:146
Nuristani	Nuristani	**hv:Degener:Nuristani**
Northeastern Pama	Northeastern Pama	**sd:VerstrateRigsby:Yintyingka**:192-194
npi	npi	**gtd:Hendriksen:Himachali**:198-206
Takuuic	Takuuic	**hv:Pawley:Polynesian-Outlier**:260-261
Wakashan	Wakashan	**hv:Stonham:Wakashan**, **hv:Campbell:1997**
Kuswaric	Kuswaric	**w:Hodgson:Broken-Nepal** **hv:vanDriem:Himalayas**:1168-1175
Lampungic	Lampungic	**hv:Anderbeck:Proto-Lampungic**
Piapoco-Achagua	Piapoco-Achagua	**hvw:Ramirez:Arawak**:231-328
mjn	mjn	**hb:Zgraggen:Madang**:9
mjo	mjo	**he:Singh:Scheduled**:723
mjh	mjh	**hew:Ebner:Wangoni**:41-43
mju	mju	**e:Kumar:Manne-Dora**
mjv	mjv	**typ:Monsy:Mannan**:139
mjp	mjp	**e:Morris:Hill-Pandaram**
mjq	mjq	**he:Thurston:SIndia:4**:387
mjr	mjr	**hw:Bhattacharya:South-Kerala**
Totonacan	Totonacan	**hv:Brownetal:Totozoquean**, **hv:MacKayTrechsel:Totonaco-Tepehuas**
mjz	mjz	**e:Gangohadhyay:Majhi**
kbj	kbj	**hv:HackettvanBulck:ETeam**:74 **s:Dijkmans:Kare** **hv:vanBulck:Bantoetaalgrens**
NOCODE_Andoquero	NOCODE_Andoquero	**hv:Loukotka:SAmerica**:187-189
kbg	kbg	**hew:Grewal:Arunachal**
vma	vma	**hv:Dench:Pilbara:Pronoun**
Kaili-Pamona-Wotu-Wolio	Kaili-Pamona-Wotu-Wolio	**hv:vandenBerg:Wolio**
Keleic	Keleic	**hv:Alewijnseetal:Gabon** **evd:Mve:Bakoya**
Gbaya-Manza-Ngbaka	Gbaya-Manza-Ngbaka	**hvphon:Monino:Proto-Gbaya** **hv:Monino:Gbaya-Manza-Ngbaka-NC**
kbu	kbu	**hvwld:Grierson:11**
Tupi-Guarani Subgroup VIII	Tupi-Guarani Subgroup VIII	**hv:Cabral:Tupi-Guarani:VIII**
Abo-Barombi	Abo-Barombi	**wsoc:Lamberty:Abo-Barombi**
tsl	tsl	**hv:Strecker:Caolan**
NOCODE_Bih	NOCODE_Bih	**g:Nguyen:Bih**:4-11
tsj	tsj	**hv:Burling:NEIndia**
Kxa	Kx'a	**hv:HeineHonken:Kxa**
Yeniseian	Yeniseian	**hv:Vajda:Yeniseic**
Mayo-Pasi	Mayo-Pasi	**hsoc:Hutchinson:Heyoetc**:128
Upper Cross	Upper Cross	**hv:Dimmendaal:UpperCross**
byf	byf	**hvtyp:Prischnegg:Yukuben**
Mbam-Nkam	Mbam-Nkam	**hv:Eliasetal:Mbam-Nkam**
byb	byb	**hv:Breton:Furu:1993**:104-105
Celtic	Celtic	**hv:Eska:Celtic**
Hoyaic	Hoyaic	**w:Carr:Foyafoya**
Saluan-Banggai	Saluan-Banggai	**hv:Mead:Saluan-Banggai**
Mbaic	Mbaic	**hvs:Pasch:Mba**
Chinali-Lahul Lohar	Chinali-Lahul Lohar	**s:Sharma:Chinali**:1
lzl	lzl	**g:Crowley:Naman**:18
Kuki-Chin	Kuki-Chin	**hv:VanBik:Proto-Kuki-Chin**
South Biu-Mandara	South Biu-Mandara	**hv:Gravina:Central-Chadic**:43-44
nfd	nfd	**hv:Blench:Prospecting** **w:Blench:Shakara** **w:Blench:Nyeng**
kpu	kpu	**hvw:Stokhof:Alor**:14-15 and the s to h sound change
bju	bju	**hv:Breton:Furu:1993**:104-105
nyg	nyg	**g:VanOtterlooVanOtterloo:Fuliiru**:1-3
kpb	kpb	**g:Lawrence:Paniya**
Jimi	Jimi	**v:Cook:Narak**
kph	kph	**hvw:Painter:Guang**
Central Naga	Central Naga	**hv:Bruhn:Central-Naga**
kpl	kpl	**hvw:BoyeldieuCloarec-Heiss:Oubanguien**
bjr	bjr	**s:Bee:Binumarien**
NOCODE_Khamnigan-Mongol	NOCODE_Khamnigan-Mongol	**s:Janhunen:Khamnigan:2003**:85-86
NOCODE_Lianmin-Yao	NOCODE_Lianmin-Yao	**hew:Suining:Suining** and p.c.~Andrew Hsiu 2014
West_Bomberai	West Bomberai	**hvld:Voorhoeve:CWTNG**:432-437
Geelvink_Bay	Geelvink Bay	**h:Jones:ECenderawasih**
Sambalic	Sambalic	**hvw:Stone:Sambalic**
hle	hle	**hel:Bradley:EAsia**:398
Hiw-Lo-Toga	Hiw-Lo-Toga	**hv:KalyanFrancois:Freeing**
Matacoan	Matacoan	**hv:ViegasBarros:Guaicuru-Mataguayo:2013**
Tuu	Tuu	**hvld:Guldemann:Lower-Nossob**, **hv:Guldemann:Khoisan:2014**
NOCODE_Kawarrang-Ogh-Undjan	NOCODE_Kawarrang-Ogh-Undjan	**hv:Black:Cape-York**:253 **s:Sommer:Undjan**
rei	rei	**hs:Mahapatra:Orissa**:112-135
Lahnda	Lahnda	**s:Shackle:Hindko**
Ronic	Ronic	**hv:Blench:Ron**
aol	aol	**hv:Doyle:Flores-Lembata** **hvw:Keraf:Lamalera**
bwg	bwg	**hsoc:Hachipola:Zimbabwe**
bwh	bwh	**hv:Breton:Furu:1993**:104-105
Semitic	Semitic	**hv:HuehnergardRubin:Semitic**
Bom-Kim	Bom-Kim	**st:Pichl:Krim**
bwn	bwn	**g:MaoLi:Baheng**
Tokharian	Tokharian	**hv:Ringe:Tocharian**
emy	emy	**g:Macri:Palenque**:30-31
Kombio-Arapesh-Urat	Kombio-Arapesh-Urat	There is decent lexicostatistical evidence for a Kombio-Arapesh group including Urat (p.c.~Matthew Dryer 2014)
Mamfe	Mamfe	**wsoc:KrugerAnderson:Kendem**
Karenic	Karenic	**hv:Manson:Karen**
Yuman	Yuman	**hvb:Golla:California**
ihw	ihw	**v:Clark:Birrdhawal**
Ambrym	Ambrym	**hvb:LynchCrowley:Vanuatu**
Slavic	Slavic	**hvtyp:SussexCubberley:Slavic**
Warrnambool-Bunganditj	Warrnambool-Bunganditj	**hv:Blake:Kulin**
Kalinga-Itneg	Kalinga-Itneg	**hv:Himes:Kalinga-Itneg**
Naga Maoic	Naga Maoic	**he:Saul:Naga-Burma**
Adharic	Adharic	**vld:Yarshater:Adhari**
Eastern Nilotic	Eastern Nilotic	**hvw:Vossen:ENilotes**
Lega	Lega	**s:Botne:Lega**:422-423
Matengic	Matengic	**hv:Nurse:SWTanzania**:93
NOCODE_Ngardi	NOCODE_Ngardi	**s:Honeyman:Ngardi**:22
Hurza	Hurza	**hv:Gravina:Central-Chadic**:45, 50
Mixtec	Mixtec	**hvw:Josserand:Mixtec**
Efate	Efate	**hvb:LynchCrowley:Vanuatu**
cya	cya	**s:McIntosh:Teotepec**
Nisu-Nyisu	Nisu-Nyisu	**hvsoc:Pelkey:Phula**
NOCODE_Passe	NOCODE_Passe	**hvw:Ramirez:Arawak**:435-446
rcf	rcf	**g:Staudacher-Valliamee:Reunionnais**
Lower_Sepik-Ramu	Lower Sepik-Ramu	**hv:Foley:Sepik-Ramu** **hv:Laycock:Sepik**
Tupian	Tup√≠an	**hv:Vilacy:Tupian** **hv:RodriguesCabral:Tupian**
Saraic	Saraic	**hv:Djarangar:Sara**
bed	bed	Data in **hw:SmitsVoorhoeve:Anceaux:A:I**, **hw:SmitsVoorhoeve:Anceaux:A:II** shows that Arguni-Bedoanas-Erokwanas forms a dialect continuum
bey	bey	**hsoc:Cooper:Belietc**:153 **hvw:Laycock:Lumi**:48
Higic	Higic	**hv:Gravina:Central-Chadic**:57-58
Modern South Arabian	Modern South Arabian	**hv:Rubin:Semitic**:75-76
Tenda	Tenda	**hv:Ferry:Parente-Atlantique**
Koam	Koam	**hv:Laycock:Sepik**
Ruvu	Ruvu	**hvw:Gonzales:Ruvu**
Jarrakan	Jarrakan	**hvw:Capell:NWAustralia**
Muruwaric	Muruwaric	**hvw:Waferetal:New-South-Wales**
mij	mij	**hvld:Goodetal:Lower-Fungom**
mia	mia	**g:Costa:Miami-Illinois**:1
South-Western Tibetic	South-Western Tibetic	**hv:Tournadre:Tibetic**
Lou-Paluai	Lou-Paluai	**g:Schokkin:Paluai**:3
Blagaric	Blagaric	**hvw:Stokhof:Alor**
pyy	pyy	**phon:Person:Pyen**:196
awy	awy	**hwsoc:Leboldetal:Lower-Digul**:4
sfw	sfw	**soc:NtumyBoafo:Sehwi**
Yuulngu	Yuulngu	**g:Wilkinson:Djambarrpuyngu**:10-14 **hv:BowernAtkinson:Pama-Nyungan**
Ekoid-Mbe	Ekoid-Mbe	**hvw:Blench:Ekoid**
Northern Pwo Karen	Northern Pwo Karen	**vw:Phillips:Pwo-Karen**
url	url	**g:Lal:Urali**
uri	uri	Some lexical evidence favours a Wapei-Palei affiliation **hvw:Laycock:Lumi**:48 **hv:GlasgowLoving:Maprik**:8 and ablaut distinctions for realis-irrealis are shared with Srenge and Walman and Yeri but these could all be retentions and do not automatically make Urim a Wapei-Palei language (p.c.~Matthew Dryer 2012)
urk	urk	**hs:Omar:Susur-Galur-Melayu** **s:Hogan:Urak**
urt	urt	**hv:GlasgowLoving:Maprik** **hvw:Laycock:Lumi**:48 I have not been able to reproduce the lexicostatistical figures from Laycock for making Urat a Wapei-Palei language specifically
ckq	ckq	**hwsoc:Martietal:Kajakse**
cks	cks	The features listed in **v:Speedy:Reunion-Tayo** are not specific to Reunion and Tayo and cannot count as unequivocal evidence for a common origin
Baka-Mundu	Baka-Mundu	**hv:Winkhart:Baka-Mundu** **h:BoydPasch:Sere-Ngbaka-Mba**
NOCODE_Dharumbal	NOCODE_Dharumbal	**s:Terrill:Dharumbal**:15
ury	ury	**phon:Fields:Orya**
Marienberg	Marienberg	**hvsoc:SandersSanders:Marienberg**
Ka-Togo	Ka-Togo	**hv:Blench:Ghana-Togo**
szb	szb	**hvw:Healey:Ok**
South Mangyan	South Mangyan	**hv:Blust:CPhilippines**
szv	szv	**hvw:Meinhof:Kamerun**
Ternate-Zamboanga-Cavite	Ternate-Zamboanga-Cavite	**g:Sippola:Chabacano**:25-27
jax	jax	**hvw:Anderbeck:Batanghari**
NOCODE_Gangou	NOCODE_Gangou	**hv:Janhunen:Amdo-Sprachbund**
Sudanese-Chadian Arabic	Sudanese-Chadian Arabic	**hvtyp:Kaye:Chadian**
Kwilu-Umlaut	Kwilu-Umlaut	**hv:KoniBostoen:Kwilu**
ksy	ksy	**s:Dasgupta:Kharia**
Levantine Arabic	Levantine Arabic	**hv:Naim:Levant**
ksz	ksz	**e:SinghDanda:Kodaku**
jak	jak	**phon:Collins:Landai**
jah	jah	**hv:Benjamin:Aslian**:145
Khantyic	Khantyic	**s:Abondolo:Khanty**:358-360
ksn	ksn	**hv:RobinsonLobel:Northeastern-Luzon**:129-130
NOCODE_Opon-Carare	NOCODE_Opon-Carare	**v:DurbinSeijas:Opon-Carare** **hv:Adelaar:Andes**:114-115
xdc	xdc	**hld:Polome:Balkans**:888
NOCODE_Naxi-Yao	NOCODE_Naxi-Yao	**vw:Long:Naxi-Yao**
Tamanic-Bugis	Tamanic-Bugis	**hv:Adelaar:Austronesian-Asia-Madagascar**:23-24
Delta Cross	Delta Cross	**hv:Connell:Cross-River**
NOCODE_Sapara	NOCODE_Sapara	**hv:Girard:Carib**
mgv	mgv	**v:Ngonyani:Ngoni**
Bantoid	Bantoid	**hv:Blench:Bantoid**
aeq	aeq	**hsoc:Rahman:Pakistan**
aew	aew	Comparison of **wsoc:Potteretal:Ambakich** and Agoan **hvld:Zgraggen:Madang** shows no special relationship
mui	mui	**hvw:Anderbeck:Batanghari**
gbh	gbh	**soc:Johnson:Defi-Gbe**
sha	sha	**w:Blench:ShallZwall**
aec	aec	**g:Khalafallah:Saidi**
shd	shd	**wtyp:RehmanBaart:KundalShahi**
shl	shl	**hv:vanDriem:Himalayas**:587
ael	ael	**hvw:Blench:Momo-Western-Momo**
jnd	jnd	**hsoc:Rahman:Pakistan**
Tupi-Guarani Subgroup II	Tupi-Guarani Subgroup II	**hv:Dietrich:Siriono-Yuki**
Tupi-Guarani Subgroup IV	Tupi-Guarani Subgroup IV	**hv:RodriguesCabral:Tupi-Guarani** **hv:Mello:Tupi-Guarani**
btf	btf	**hwsoc:Martietal:Kajakse** **w:Jungraithmayr:Birgit**
Adamawa Fali	Adamawa Fali	**hv:Boyd:Adamawa-Ubangi**:180
btc	btc	**soc:Grant:Bati**
Ambel-Biga	Ambel-Biga	**hv:Kamholz:South-Halmahera-West-New-Guinea**:137
Kilimanjaro-Taita	Kilimanjaro-Taita	**hv:Nurse:EBantu**
btj	btj	**v:Collins:Bacan**
Libyan-Egyptian Oases Berber	Libyan-Egyptian Oases Berber	**gv:Souag:Siwa**:17-26
dlk	dlk	**w:Simeone-Senelle:Dahalik**
dln	dln	**hb:Matisoff:Tibeto-Burman**
lue	lue	**hv:Bastinetal:Bantu**:216
luj	luj	**s:Westcott:Luna-Inkongo**
lum	lum	**vtyp:White:West-Central-Bantu:Noun**
jor	jor	**ew:Hanke:Jora** **hvw:Firestone:Tupi-Guarani**:69
kej	kej	**hb:RamaiahReddy:Tribal-Dravidian**
Kalenjin	Kalenjin	**hvw:Distefano:Kalenjin**
NOCODE_Pollapese	NOCODE_Pollapese	**phon:Crippen:Pollapese:Sounds**:1
key	key	**phon:ChristmasChristmas:Kupia**
NOCODE_Gulf-Coast-French	NOCODE_Gulf-Coast-French	**g:Moreton:MGCF**
kev	kev	**hw:Bhattacharya:South-Kerala**
Likouala-Sangha	Likouala-Sangha	**hv:Bastinetal:Bantu**:204-205 **hvld:BouquiauxThomas:C10**
keq	keq	**hvw:Grierson:7**:386 **e:RussellHiralal:Kamar**
kep	kep	**hvwld:Grierson:4**
tlq	tlq	**hv:Hsiu:Angkuic**
NOCODE_Tangwang	NOCODE_Tangwang	**s:Lee-Smith:Tangwang**
NOCODE_Rundi-Kitwa	NOCODE_Rundi-Kitwa	**w:vanderBurgt:Watwa**
Banda-Geser	Banda-Geser	**hvw:Collins:ESeram**
tli	tli	**hv:Leer:AET**
tln	tln	**hv:Valkama:Mamuju**
NOCODE_Koko-Dhawa	NOCODE_Koko-Dhawa	**s:Sommer:Dhawa**:3, 19
Zamucoan	Zamucoan	**hv:Ciucci:Zamucoan**
Zapotec	Zapotec	**hv:Operstein:Zapotec**
Anyinic	Anyinic	**soc:NtumyBoafo:Sehwi**
bbm	bbm	**s:Mangulu:Ebango**:5
Muskogean	Muskogean	**hv:Martin-Munro:Proto-Muskogean**
bbg	bbg	**hv:Bastinetal:Bantu**:200
Nuclear Mondzish	Nuclear Mondzish	**hvw:Hsiu:Mondzish**
lep	lep	**hv:vanDriem:Himalayas**
South Halmahera-West New Guinea	South Halmahera-West New Guinea	**hv:Kamholz:South-Halmahera-West-New-Guinea**:136-137
Maroua	Maroua	**hv:Gravina:Central-Chadic**:55-56
Lolo-Burmese	Lolo-Burmese	**hv:Bradley:Tibeto-Burman** **hv:Bradley:Burmic**
yac	yac	**hvld:Voorhoeve:CWTNG**
lgi	lgi	**hvw:Blust:Saban** **hv:Sellato:Kenyah-Putuk**:35-37
NOCODE_Afudu	NOCODE_Afudu	**hv:Johnston:Semi-Bantu:1917** and p.c.~Roger Blench 2012
Tujia	Tujia	**h:Bradley:Tibeto-Burman-China**
lgz	lgz	**s:Motingea:Genja**
Greater_Kwerba	Greater Kwerba	**h:ClouseDonohueMa:NCoast**
hmf	hmf	**hvb:Niederer:Hmong-Mjen**:310-311
Huon Gulf	Huon Gulf	**hv:Ross:WMelanesia**:132-159
Sepik	Sepik	**hvld:LaycockZGraggen:Sepik-Ramu**
yso	yso	**hvsoc:Pelkey:Phula**:392
cov	cov	**v:Shi:Cao-Miao**
ysy	ysy	**hsoc:Bradley:Sanie**
Nuni	Nuni	**hvw:Malgoubri:Nuni**
Mailuan	Mailuan	**hv:Dutton:Mailu** **hv:Dutton:Southeast-Mainland-Papua**
Sabellic	Sabellic	**s:Wallace:Sabellic**
wkl	wkl	**he:Fuchs:India**
Guadalcanal-Nggelic	Guadalcanal-Nggelic	**hv:Pawley:Guadalcanal-Nggelic**
wkb	wkb	**hsoc:Mathew:Wayanad**
Western Lakes Bantu	Western Lakes Bantu	**hvw:Schoenbrun:Great-Lakes-Bantu**, **hv:Schoenbrun:Great-Lakes-Bantu:1994**
Lebonya	Lebonya	**hv:Bastinetal:Bantu**:211
Northern South Sulawesi	Northern South Sulawesi	**hvw:Smith:Ulunnu** **hvw:GrimesGrimes:South-Sulawesi**
Yareban	Yareban	**hv:Dutton:SEPapua**:14-15
wku	wku	**he:Thurston:SIndia:4**:119-122
Mumuyeic	Mumuyeic	**hvw:Shimizu:Mumuye**
Nyamwezic	Nyamwezic	**hvw:Masele:F**
fkk	fkk	**w:BlenchNdamsai:Kirya-Konzel**
nod	nod	**hv:Pittayaporn:Southwestern-Tai**
Small Nambas	Small Nambas	**hvw:Tryon:NewHebrides**
Quechuan	Quechuan	**hv:Adelaar:Andes**:183-188 **hv:Adelaar:Quechua-I-II**
Molet-Asaroo	Molet-Asaroo	**w:Carteretal:Mur**
fkv	fkv	**s:Lindgren:Kven-Finnish**
NOCODE_Bangru	NOCODE_Bangru	**hv:Sun:Tani**:159 **vphon:BodtLieberherr:Bangru**
mzt	mzt	**hvw:Benjamin:Prehistory**
Lalo	Lalo	**hvwphon:Yang:Lalo**
Axamb-Avok	Axamb-Avok	**hvb:LynchCrowley:Vanuatu**:75
mzs	mzs	**g:Arana-Ward:Macanese**
amn	amn	**hv:BassLoving:Amanab**
mzz	mzz	Data in **ld:Anonymous:Maiadom** suggest that Iamalele is closest
mzd	mzd	**wdial:Lamberty:Malimba**
Sabi	Sabi	**hv:Ahmed:East-Central-Africa**
phq	phq	**hel:Bradley:EAsia**:365
phv	phv	**hb:Redard:Other-Iranian**
Nisu	Nisu	**hv:Yang:Nisu**
Amami	Amami	**g:Pellard:Ogami**:249-276
Yaoic	Yaoic	**hv:Nurse:SWTanzania**:94
Pomo-Bomwali	Pomo-Bomwali	**hv:Klieman:Gabon**
Thura-Yura	Thura-Yura	**hv:SimpsonHercus:Thura-Yura** **hv:BowernAtkinson:Pama-Nyungan**
Unua-Pangkumu	Unua-Pangkumu	**g:Pearce:Unua**
Ny√¢layu	Ny√¢layu	**g:McCracken:Belep**:22-25
mfa	mfa	**g:Tadmor:Malay-Nonthaburi**
Tamangic	Tamangic	**s:Noonan:Chantyal** **hv:Honda:Tamangic**
Kilombero	Kilombero	**hv:Nurse:EBantu**
NOCODE_Yagara	NOCODE_Yagara	**hvw:Jefferies:Guwar**:61-66
tck	tck	**hv:Alewijnseetal:Gabon**
Balochic	Balochic	**s:JahaniKorn:Balochi**
ist	ist	**s:BartoliVidossi:Venezia-Giulia**
igg	igg	**hb:Zgraggen:Madang**
wea	wea	**hld:Grierson:12:Burma**
skq	skq	**soc:Kedrebeogo:Sillanko**
South_Bougainville	South Bougainville	**hv:Evans:SBougainville** **hv:Onishi:South-Bougainville**
adq	adq	**s:Sprigge:Adangbe-Ewe**
Northern Benue-Congo Plateau	Northern Benue-Congo Plateau	**w:Blench:Ejegha**
Dabaic	Dabaic	**hv:Gravina:Central-Chadic**:46, 48
Nyawaygic	Nyawaygic	**hv:Dixon:Cairns** **h:Dixon:Australian2002**:xxv, xxxiii
gmx	gmx	**phont:Schadeberg:Kinga**:1
Torres-Banks linkage	Torres-Banks linkage	**hv:Francois:Ecology:NVanuatu**
Abkhaz-Adyge	Abkhaz-Adyge	**hv:Hewitt:NWC**
Jivaroan	Jivaroan	**g:Overall:Aguaruna**:4-5
New Ireland-Northwest Solomonic linkage	New Ireland-Northwest Solomonic linkage	**hv:Ross:New-Ireland** **hv:Ross:WMelanesia**:257-314
Bukat-Ukit-Beketan-Lugat-Lisum	Bukat-Ukit-Beketan-Lugat-Lisum	**he:SellatoSercombe:Borneo-Hunter-Gatherer**:12 **hvld:SellatoSoriente:Muller**
Baka-Gundi	Baka-Gundi	**hw:Ouzilleau:Pygmees**
Tsingi-Tsingi	Tsingi-Tsingi	**hv:Mangulu:Bassin-Congolais** **hv:Bastinetal:Bantu**:206, 208-209
Samba Duru-Mumuye Yendang	Samba Duru-Mumuye Yendang	**hv:Boyd:Adamawa-Ubangi**:179
Agoan	Agoan	**hvld:Zgraggen:Madang**:166-167
Kartu	Kartu	**hv:Austin:Gascoyne-Ashburton** **hv:Austin:SPilbara**
Kuki-Chin-Naga	Kuki-Chin-Naga	**hv:Burling:NEIndia**
Awyu-Ok	Awyu-Ok	Contra **hv:vandenHeuvelFedden:Greater-Awyu-Ok** the lexical material is easiest explainable as shared history
Ngayarda	Ngayarda	**hv:Austin:SPilbara** **hv:OGrady:Proto-Ngayarda** **g:Dench:Martuthunira**:3-5 **hv:Dench:Pilbara**
Warisic	Warisic	**hvw:Seiler:Imonda-Related**
NOCODE_Haraza	NOCODE_Haraza	**vw:Bell:Haraza** **hv:Rilly:Meroitique**:166
Central Luzon	Central Luzon	**hv:Blust:CPhilippines**:79-80 **hv:Himes:Central-Luzon**
Kulango-Lorom	Kulango-Lorom	**g:Elders:Kulango**
kwr	kwr	**hvw:Wilbrink:Kopkaka**
xsd	xsd	**hv:Melchert:Anatolia**:2157-2158
Misumalpan	Misumalpan	**hv:Pineda:Misumalpan**
mhp	mhp	**h:AdelaarPrentice:Malay**
Oceanic	Oceanic	**hv:LynchRossCrowley:Subgrouping**
Caribbean Arawakan	Caribbean Arawakan	**hv:Captain:Lokono-Guajiro**
Mayan	Mayan	**hv:Campbell:Mayan:2015**
Dogoso-Khe	Dogoso-Khe	**hv:Winkelmann:Khe-Dogosu**
Miwokan	Miwokan	**hvw:Callaghan:Utian**:8-9
Ababuan	Ababuan	**hvw:McMaster:Uele**
Sundi-Kamba	Sundi-Kamba	**hv:Bastinetal:Bantu**:214-215
Macro-Bai	Macro-Bai	**h:Hsiu:Southwestern-China**
tmp	tmp	**hv:EdmondsonSolnit:Kadai-Tai:Introduction**
Kuansi-Kuamasi-Sonaga	Kuansi-Kuamasi-Sonaga	**hvwsoc:Castroetal:Yi**
tmw	tmw	**he:Carey:Orang-Asli**:241
Phoenician-Punic	Phoenician-Punic	**s:Hackett:Phoenician-Punic**
Kam-Sui	Kam-Sui	**hv:Thurgood:Proto-Kam-Sui**
tml	tml	**hvw:Voorhoeve:Asmat**
Paku-Mobwa	Paku-Mobwa	**hv:Shintani:Brakaloungic**
North Biu-Mandara	North Biu-Mandara	**hv:Gravina:Central-Chadic**:44-45
Castilic	Castilic	**hv:Agard:Romance**:108-115
Biakic	Biakic	**hv:Kamholz:South-Halmahera-West-New-Guinea**:138
dcc	dcc	**hvw:Grierson:7**
West_Bird's_Head	West Bird's Head	**hv:BerryBerry:WPapuan**
Tsimshian	Tsimshian	**g:Tarpent:Nisgha**
Saw	Saw	**hv:HackettvanBulck:ETeam**:70-71 **hel:Mangulu:RDC**:149-150
ndb	ndb	**phon:DeVries:Bamessing**:3-4
NOCODE_Girirra	NOCODE_Girirra	**h:Banti:Somali**
kra	kra	**hv:vanDriem:Himalayas**:1175
North-Central Jos	North-Central Jos	**hvw:Shimizu:Jos**
NOCODE_Tacunyape	NOCODE_Tacunyape	**hv:Loukotka:SAmerica**:112-113
Southern Tanzania Highlands Bantu	Southern Tanzania Highlands Bantu	**hv:Nurse:EBantu**
Ulchaic	Ulchaic	**hv:Janhunen:Expansion-Tungusic**:6
Njebe-Mbete-Teke	Njebe-Mbete-Teke	**hvwsoc:Lane:Mbete**
Melanau	Melanau	**hv:Kroeger:Sarawak**:161-162
vaa	vaa	**g:Srinivasa:Vaagri-Boli**:i but shared numeral innovations with Bhil
Kainantu-Goroka	Kainantu-Goroka	**hv:Xiao:HAB** **hv:Foley:Papuan**:245-257
Gudanji-Binbinga-Wambaya	Gudanji-Binbinga-Wambaya	**hvtyp:Chadwick:WBarkly**
vas	vas	**e:Hakim:Vasavi**
Bohtan	Bohtan	**s:Fox:Bohtan**:166
Central Jukunoid	Central Jukunoid	**hvw:Storch:Zentral-Jukunoid**
Lower Guinea Portuguese	Lower Guinea Portuguese	**hv:Hagemeijer:Gulf-Guinea**
Kwilu-Nsong	Kwilu-Nsong	**hv:KoniBostoen:Kwilu**
buh	buh	**s:MaoLi:Younuo**
Arafundi	Arafundi	**ew:Haberland:Alfendio**
Jarawan	Jarawan	**hvw:MaddiesonWilliamson:Jarawan**
dmk	dmk	**v:Buddruss:Domaaki**
dmr	dmr	**hvw:Taber:SWMaluku**
dmx	dmx	**e:Hasler:Mvura**
pih	pih	**ld:Laycock:Pitcairn-Norfolk**
pii	pii	**dialsoc:Berndt:Western-Desert**
Nyulnyulan	Nyulnyulan	**hv:StokesMcGregor:Nyulnyulan**
Guaicuruan	Guaicuruan	**hv:ViegasBarros:Guaicuru-Reconstruccion:2013**
pie	pie	**hvbtyp:Sutton:Kiowa-Tanoan**:5-6
Old Kuki	Old Kuki	**hv:VanBik:Proto-Kuki-Chin** **vwphon:MortensenKeogh:Sorbung**
myc	myc	**he:deCalonne:Ubangi-Uele-Aruwimi**:114, 120, 247, 251
Lowland East Cushitic	Lowland East Cushitic	**hv:Tosco:Cushitic**:95-98
hld	hld	**h:Schliesinger:Laos**
hns	hns	**ld:Damsteegt:Sarnami**
wxa	wxa	**hv:Chappell:Sinitic**
South Sulawesi	South Sulawesi	**hvw:GrimesGrimes:South-Sulawesi** **hv:Sirk:SSulawesi**
Maric	Maric	**hv:Sutton:Gugu-Badhun** **hvw:Barrett:Maric**
Mandi-Nyokon	Mandi-Nyokon	**hv:MousBreedveld:Bantu-A40-A60**
Costanoan	Costanoan	**hvw:Callaghan:Utian**:14-18
Eastern_Trans-Fly	Eastern Trans-Fly	**hvld:Wurm:Trans-Fly:1971**:146
Yangmanic	Yangmanic	**hv:Merlan:Wardaman-Relationships**
ubi	ubi	**v:Blazek:Ubi**
gao	gao	**typ:Daniels:Sogeram**
Ngiri	Ngiri	**hv:Mangulu:Ngiri**
Enga-Kewa-Huli	Enga-Kewa-Huli	**hv:Franklin:Engan**
Biu-Mandara	Biu-Mandara	**hv:Gravina:Central-Chadic**
bct	bct	**w:Liesenborghs:Mabendi** **g:Kutsch:Ngiti**:451 **hwb:Bokula:Irumu:Moru-Mangbetu**:226
Bidayuh-Rejang	Bidayuh-Rejang	**hv:McGinn:Rejang-Borneo**
NOCODE_Ngala-Barth	NOCODE_Ngala-Barth	**hw:Benton:WSudan**
