NOCODE_Jan-Awei	Nigeria
xtw	Brazil
xtu	Mexico
xtt	Mexico
xts	Mexico
xtq	China
xtp	Mexico
xtz	Australia
xty	Mexico
xtg	France
xte	Indonesia (Papua)
xtd	Mexico
xtc	Sudan
xtb	Mexico
xta	Mexico
xto	China
xtn	Mexico
xtm	Mexico
xtl	Mexico
xtj	Mexico
xti	Mexico
wji	Nigeria
wja	Nigeria
tmv	Democratic Republic of the Congo
mlj	Chad
NOCODE_Old-Telugu	India
NOCODE_Lwel	Democratic Republic of the Congo
NOCODE_Original-Costa-Rican-Sign	Costa Rica
NOCODE_Pyu-Burma	Myanmar
txo	India
txn	Indonesia (Papua)
txm	Indonesia (Papua)
txj	Nigeria
txi	Brazil
txh	Bulgaria
txg	China
txe	Indonesia (Papua)
txc	Canada
txb	China
txa	Malaysia (Peninsular)
NOCODE_Kuntanawa	Brazil
NOCODE_Remo-Jaquirana	Brazil
txx	Malaysia (Peninsular)
txu	Brazil
txt	Indonesia (Papua)
txs	Indonesia (Papua)
txr	Spain
txq	Indonesia (Papua)
dne	Tanzania
dnd	Papua New Guinea
dng	Uzbekistan	Kyrgyzstan	Turkmenistan	Kazakhstan	Russian Federation (Asia)	Tajikistan
dna	Indonesia (Papua)
dnn	Burkina Faso
dni	Indonesia (Papua)
dnk	Indonesia (Papua)
dnu	Myanmar
dnt	Indonesia (Papua)
dnw	Indonesia (Papua)
dnr	Papua New Guinea
dny	Brazil
jmx	Mexico
jmr	Ghana
jms	Nigeria
jmw	Papua New Guinea
jmk	Sweden
jmi	Nigeria
jmn	India
jml	Nepal
jmb	Nigeria
jmc	Tanzania
jma	Papua New Guinea
jmd	Indonesia (Papua)
NOCODE_Cholti	Guatemala
NOCODE_Horace-Holdens-Pidgin-Tobi	Palau
czt	Myanmar
czh	China
czn	Mexico
czo	China
hod	Nigeria
hoe	Nigeria
hob	Papua New Guinea
hoc	India
hoa	Solomon Islands
hoo	Democratic Republic of the Congo
hol	Democratic Republic of the Congo	Angola
hom	Sudan
hoj	India
hoh	Oman	Yemen
hoi	United States
hov	Indonesia (Papua)
how	China
hot	Papua New Guinea
hor	Chad
hos	Viet Nam
hop	United States
hoz	Ethiopia
hoy	India
NOCODE_Maku	Brazil
NOCODE_New-South-Wales-Pidgin	Australia
NOCODE_Uwinymil	Australia
NOCODE_Arazaire	Peru
NOCODE_Palewyami-Yokuts	United States
fir	Nigeria
fip	Tanzania	Malawi
fiw	Papua New Guinea
fit	Sweden	Finland
fia	Egypt	Sudan
fie	Nigeria
fij	United States	Nauru	Fiji	New Zealand	Vanuatu
fin	Canada	United States	Estonia	Finland	Russian Federation (Asia)	Sweden	Norway
zad	United States	Mexico
fil	Philippines
NOCODE_Bacama-Yimburu	Nigeria
NOCODE_Serengeti-Dorobo	Tanzania
tch	Turks and Caicos Islands
NOCODE_Coroado-Puri	Brazil
mdj	Democratic Republic of the Congo
mdk	Democratic Republic of the Congo
mdh	Philippines
mdi	Democratic Republic of the Congo
mdn	Central African Republic
mdl	Malta
mdm	Democratic Republic of the Congo
mdb	Papua New Guinea
mdc	Papua New Guinea
mda	Nigeria
mdf	Russian Federation (Asia)
mdg	Chad
mdd	United States	Cameroon	Central African Republic
mde	Chad
mdz	Brazil
mdx	Ethiopia
mdy	Ethiopia
NOCODE_Mokpa	Democratic Republic of the Congo
mdr	Indonesia (Papua)
mds	Papua New Guinea
mdp	Democratic Republic of the Congo
mdq	Democratic Republic of the Congo
mdv	Mexico
mdw	Congo
mdt	Congo	Gabon
mdu	Congo
NOCODE_Macuni	Brazil
smz	Papua New Guinea
smy	Iran
smx	Democratic Republic of the Congo
smw	Indonesia (Papua)
smv	India
smu	Cambodia
smt	India
sms	Russian Federation (Asia)	Finland
smr	Indonesia (Papua)
smq	Papua New Guinea
smp	Israel	Palestinian West Bank and Gaza
dsn	Indonesia (Papua)
dso	India
smm	Nepal
sml	Philippines
smk	Philippines
smj	Sweden	Norway
dsh	Ethiopia	Kenya
smh	China
smg	Papua New Guinea
smf	Papua New Guinea
sme	Sweden	Finland	Norway
smd	Angola
dsb	United States	Germany
smb	Papua New Guinea
sma	Sweden	Norway
syo	Cambodia
syn	United States	Australia	Iran
ian	Papua New Guinea
atg	Nigeria
atd	Philippines
ate	Papua New Guinea
atb	China	Myanmar
atc	Peru
ata	Papua New Guinea
atn	Iran
ato	Cameroon
atl	Philippines
atm	Philippines
atj	Canada
atk	Philippines
ati	Côte d'Ivoire
atv	Russian Federation (Asia)
atw	United States
att	Philippines
atu	Sudan
atr	Brazil
ats	United States
atp	Philippines
atq	Indonesia (Papua)
atz	Philippines
atx	Brazil	Venezuela
aty	Vanuatu
kfv	Nepal	India
kfw	India
kft	India
kfu	India
kfr	Kenya	Tanzania	India	Malawi	Pakistan
qkn	India
kfp	India
kfq	India
kfz	Burkina Faso	Mali
kfx	India
kfy	India
kff	India
kfg	India
kfd	India
kfe	India
kfb	India
kfc	India
kfa	India
kfn	Cameroon
kfo	Côte d'Ivoire
kfl	Cameroon
kfm	Iran
kfk	India
kfh	India
kfi	India
xia	China
NOCODE_Lule	Argentina
xii	Namibia	South Africa
NOCODE_Old-Cayman-Sign	Cayman Islands
xil	Albania
xin	Guatemala
xip	Brazil
xir	Brazil
xiy	Brazil
NOCODE_Rocorona	Bolivia
nzs	New Zealand
nzu	Congo
nzz	Mali
nzy	Cameroon	Chad
nzb	Congo	Gabon
nza	Nigeria	Cameroon
NOCODE_Bapen	Senegal
nzk	Democratic Republic of the Congo	Central African Republic
nzi	Ghana	Côte d'Ivoire
nzm	India
NOCODE_Solombala-English	Russia
vgt	Belgium
vgr	Pakistan
NOCODE_Broken-Slavey	Canada
lpx	Sudan
lpo	China
lpn	Myanmar
lpe	Indonesia (Papua)
lpa	Vanuatu
neb	Côte d'Ivoire
ztm	Mexico
ztl	Mexico
ztn	Mexico
zte	Mexico
ztg	Mexico
NOCODE_Oyster-Bay-Big-River-Little-Swanport	Australia
zty	Mexico
ztx	Mexico
ztu	Mexico
ztt	Mexico
ztq	Mexico
ztp	Mexico
zts	Mexico
NOCODE_Gudjal	Australia
NOCODE_Millcayac	Argentina
NOCODE_Cotoxo	Brazil
irx	Indonesia (Papua)
iry	Philippines
irr	Laos
iru	India
xvi	Afghanistan	Pakistan
iri	Nigeria
irk	Tanzania
NOCODE_Patagon	Peru
irn	Brazil
xve	Italy
ire	Indonesia (Papua)
wtw	Indonesia (Papua)
cuu	Thailand	China
rgs	Viet Nam
wtf	Papua New Guinea
wti	Sudan	Ethiopia
wtk	Papua New Guinea
wtm	India
rgu	Indonesia (Papua)
NOCODE_Yagara	Australia
ane	New Caledonia
NOCODE_Aruan	Brazil
anf	Ghana
prf	Philippines
gxx	Côte d'Ivoire
frc	United States
fra	Canada	Madagascar	Italy	U.S. Virgin Islands	Guinea	Saint Pierre and Miquelon	Mali	Cambodia	France	Andorra	Democratic Republic of the Congo	Saudi Arabia	Rwanda	Vanuatu	Cameroon	Burkina Faso	Benin	Israel	Lebanon	Algeria	Austria	Togo	Martinique	Belgium	Senegal	Haiti	French Polynesia	Mauritania	Libya	Mayotte	Philippines	Puerto Rico	Central African Republic	New Caledonia	Mauritius	Morocco	Réunion	Gabon	Luxembourg	Monaco	Switzerland	Wallis and Futuna	Guadeloupe	Côte d'Ivoire	United States	Seychelles	Chad	Equatorial Guinea	Tunisia	United Arab Emirates	South Africa	India	United Kingdom	Djibouti	Congo	Mozambique	Burundi	French Guiana	Niger	Comoros
prc	Afghanistan
frd	Indonesia (Papua)
frk	Germany
prb	Thailand
fro	France
frs	Canada	United States	Germany
frr	Germany
frq	Papua New Guinea
frp	Switzerland	Italy	France
frt	Vanuatu
cuc	Mexico
fry	Netherlands
pro	France
cub	Brazil	Venezuela	Colombia
ano	Colombia
anh	Papua New Guinea
prh	Philippines
anj	Papua New Guinea
cum	Colombia
pru	Indonesia (Papua)
cul	Brazil	Peru
anu	Sudan	Ethiopia
anv	Cameroon
sjr	Papua New Guinea
rgn	Italy
NOCODE_Belle-Isle-Pidgin	Canada
sjp	India
NOCODE_Bauxite	Guinea
tzs	Mexico
tzu	Mexico
tzt	Guatemala
tzx	Papua New Guinea
tzz	Mexico
drt	Netherlands
tza	Tanzania
tzc	Mexico
tzb	Mexico
tze	Mexico
sjt	Russian Federation (Asia)
tzi	China
tzh	Mexico
tzj	Guatemala
tzm	Morocco	Algeria	France
tzl	United States
tzo	Mexico
tzn	Indonesia (Papua)
dho	India
dhn	India
dhm	Namibia	Angola
dhl	Australia
dhi	Nepal	India
sjk	Finland
dhg	Australia
anx	Papua New Guinea
dhd	India
dha	India
prx	India
dhw	Nepal
dhv	New Caledonia
dhu	Australia
dhs	Tanzania
dhr	Australia
drl	Australia
sjl	India
jku	Nigeria
sjm	Philippines	Malaysia (Peninsular)
jkr	India
jkm	Myanmar
jko	Papua New Guinea
drb	Sudan
sjg	Chad
drg	Malaysia (Peninsular)
hah	Papua New Guinea
bnz	Cameroon
bny	Malaysia (Peninsular)
hak	Canada	Brunei	United States	Singapore	Panama	South Africa	Malaysia (Peninsular)	French Polynesia	United Kingdom	Indonesia (Papua)	French Guiana	Suriname	Thailand	China	New Zealand	Mauritius	Taiwan
hal	Viet Nam	Laos
ham	Papua New Guinea
han	Tanzania
hao	Papua New Guinea
bns	India
haa	Canada	United States
bnq	Indonesia (Papua)
bnp	Papua New Guinea
bnw	Papua New Guinea
bnv	Indonesia (Papua)
bnu	Indonesia (Papua)
hag	Ghana
bnk	Vanuatu
bnj	Philippines
bni	Democratic Republic of the Congo	Congo	Central African Republic
bno	Philippines
bnn	Taiwan
bnm	Cameroon	Equatorial Guinea
bnl	Somalia
hap	Indonesia (Papua)
bnb	Malaysia (Peninsular)
bna	Indonesia (Papua)
has	Canada
bng	Gabon	Equatorial Guinea
bnf	Indonesia (Papua)
bne	Indonesia (Papua)
bnd	Indonesia (Papua)
NOCODE_Miisiirii	Sudan
ola	Nepal	India
old	Tanzania
ole	Bhutan
olm	Nigeria
olo	Russian Federation (Asia)	Finland
umu	Canada
ump	Australia
for	Papua New Guinea
fos	Taiwan
fod	Ghana	Benin
umd	Australia
umg	Australia
uma	United States
umb	Namibia	Angola
umm	Nigeria
fom	Democratic Republic of the Congo
umo	Brazil
umn	Myanmar
umi	Malaysia (Peninsular)
foi	Papua New Guinea
NOCODE_Woiwurrung	Australia
mbl	Brazil
mbm	Congo	Gabon
mbn	Colombia
mbo	Cameroon
mbh	Papua New Guinea
mbi	Philippines
mbj	Brazil
NOCODE_Ham	Chad
mbd	Philippines
mbe	United States
mbf	Malaysia (Peninsular)	Singapore
soj	Iran
som	Canada	Saudi Arabia	Italy	United Arab Emirates	Finland	Sweden	United Kingdom	Ethiopia	Djibouti	Somalia	Oman	Kenya	Yemen
mba	Philippines
soo	Democratic Republic of the Congo
mbc	Brazil	Venezuela	Guyana
soq	Papua New Guinea
sop	Democratic Republic of the Congo
sos	Burkina Faso
sor	Chad
mbx	Papua New Guinea
mby	Pakistan
mbz	Mexico
sov	Palau	Northern Mariana Islands
mbt	Philippines
sox	Cameroon
mbv	Guinea
soz	Tanzania
mbp	Colombia
mbq	Papua New Guinea
mbr	Colombia
mbs	Philippines
NOCODE_Kuungkari	Australia
azj	Ukraine	Uzbekistan	Kyrgyzstan	Georgia	Turkmenistan	Estonia	Azerbaijan	Russian Federation (Asia)	Armenia	Kazakhstan
azm	Mexico
azn	Mexico
azo	Cameroon
aza	China
azb	Turkey (Asia)	Afghanistan	Iran	Azerbaijan	United States	Jordan	Syria	Iraq
azd	Mexico
azg	Mexico
azz	Mexico
azt	Philippines
khx	Democratic Republic of the Congo
khy	Democratic Republic of the Congo
khz	Papua New Guinea
khp	Indonesia (Papua)
khq	Mali
khr	Nepal	India
khs	Papua New Guinea
kht	India	Myanmar
khu	Namibia	Angola
khv	Russian Federation (Asia)
khw	Pakistan	India
khh	Indonesia (Papua)
khj	Nigeria
khk	Russian Federation (Asia)	United States	Kyrgyzstan	Taiwan	Mongolia
khl	Papua New Guinea
khm	Canada	Viet Nam	Cambodia	France	United States	China	Laos
khn	India
kho	China
kha	India	Bangladesh
khb	Viet Nam	Thailand	China	Myanmar	Laos
khc	Indonesia (Papua)	Singapore
khd	Indonesia (Papua)
khe	Indonesia (Papua)
khf	United States	China	Laos
khg	China
xkj	Iran
xkk	Cambodia
xkh	Brazil
xki	Kenya
xkn	Indonesia (Papua)
xko	Myanmar	Laos
xkl	Indonesia (Papua)	Malaysia (Peninsular)
xkb	Togo	Benin
xkc	Iran
xka	Pakistan
xkf	Bhutan
xkg	Mali
xkd	Indonesia (Papua)
xke	Indonesia (Papua)
xkz	Bhutan
xkx	Papua New Guinea
xky	Indonesia (Papua)	Malaysia (Peninsular)
xkr	Brazil
xks	Indonesia (Papua)
xkp	Iran
xkq	Indonesia (Papua)
xkv	Namibia	Botswana
xkw	Indonesia (Papua)
xkt	Ghana	Burkina Faso
xku	Congo
nxu	Indonesia (Papua)
nxq	China
nxr	Indonesia (Papua)	Papua New Guinea
nxx	Indonesia (Papua)
nxe	Indonesia (Papua)
nxd	Democratic Republic of the Congo
nxg	Indonesia (Papua)
nxa	East Timor
nxm	Libya
nxl	Indonesia (Papua)
nxo	Gabon
nxn	Australia
nxi	Tanzania
osx	Germany
osp	Spain
oss	Turkey (Asia)	Ukraine	Georgia	Turkmenistan	Tajikistan	Azerbaijan	Russian Federation (Asia)	Uzbekistan	Germany	Kazakhstan
osu	Papua New Guinea
ost	Cameroon
peq	United States
osi	Indonesia (Papua)
nlr	Australia
oso	Nigeria
osa	United States
nlu	Ghana
osc	Italy
ver	Nigeria	Cameroon
vep	Russian Federation (Asia)
nlv	Mexico
tkn	Japan
ved	Sri Lanka
NOCODE_Shang	Nigeria
NOCODE_Upper-Umpqua	United States
NOCODE_Pinghua	China
ven	Zimbabwe	South Africa
veo	United States
vel	Netherlands
vem	Nigeria	Cameroon
lra	Indonesia (Papua)	Malaysia (Peninsular)
lrc	Iran
nlz	Solomon Islands
lre	Canada
lrg	Australia
lri	Kenya
lrk	Pakistan
lrm	Kenya
lrl	Iran
lro	Sudan
lrn	Indonesia (Papua)
lrr	Nepal
lrt	Indonesia (Papua)
lrv	Vanuatu
lrz	Vanuatu
tkv	Papua New Guinea
nlc	Indonesia (Papua)
tkr	Russian Federation (Asia)	Uzbekistan	Azerbaijan
tks	Iran
nlg	Solomon Islands
bln	Philippines
NOCODE_South-Eastern-Tasmanian-Hinterland	Australia
zrs	Indonesia (Papua)
zrp	France
NOCODE_Ngen	Côte d'Ivoire
zrg	India
tkx	Indonesia (Papua)
zro	Ecuador
zrn	Chad
NOCODE_Mimi-Nachtigal	Chad
ydk	Papua New Guinea
ydg	Pakistan
ydd	Canada	Panama	Lithuania	Costa Rica	Argentina	Israel	Belarus	Puerto Rico	Belgium	Ukraine	Poland	Moldova	United States	Sweden	Latvia	Romania	Estonia	Uruguay	Australia	South Africa	Russian Federation (Asia)	Hungary
yde	Papua New Guinea
yds	Israel
ipi	Papua New Guinea
ipo	Papua New Guinea
NOCODE_Butler-English	India
NOCODE_Borgarmalet	Sweden
dzo	Nepal	India	Bhutan
NOCODE_Lower-Nosop	South Africa
gzn	Indonesia (Papua)
gzi	Iran
gza	Ethiopia
NOCODE_Iraqi-Sign	Iraq
dyy	Australia
fpe	Equatorial Guinea
dyu	Côte d'Ivoire	Burkina Faso	Mali
ssl	Ghana
dyn	Australia
dyo	Gambia	Senegal	Guinea-Bissau
ssh	United Arab Emirates	Oman
ttz	Nepal
tty	Indonesia (Papua)
NOCODE_Medefidrin	Nigeria
tts	Thailand
ttr	Nigeria
ttq	Niger	Nigeria	Mali
ttp	Indonesia (Papua)
ttw	Malaysia (Peninsular)
ttv	Papua New Guinea
ttu	Papua New Guinea
ttt	Russian Federation (Asia)	Iran	Azerbaijan
ttk	Colombia
ttj	Uganda
tti	Indonesia (Papua)
tth	United States	Viet Nam	Laos
tto	Laos
ttn	Indonesia (Papua)
ttm	Canada
ttl	Zambia	Namibia
ttc	Guatemala	Mexico
ttb	Nigeria
tta	United States
ttg	Brunei
ttf	Cameroon
tte	Papua New Guinea
ttd	Papua New Guinea
jig	Australia
jid	Nigeria
djr	Australia
dju	Papua New Guinea
jic	Honduras
djw	Australia
jia	Cameroon
jio	China
jil	Papua New Guinea
jim	Cameroon
jih	China
jii	Somalia
jiv	Ecuador
djc	Chad
djb	Australia
NOCODE_Abai-Tubu-Sembuak	Malaysia (Peninsular)
djd	Australia
djf	Australia
dji	Australia
djk	French Guiana	Suriname
djj	Australia
djm	Burkina Faso	Mali
djl	Australia
djo	Indonesia (Papua)
djn	Australia
NOCODE_Chholo	Bolivia
NOCODE_Amotomanco	Mexico
NOCODE_Tosu	China
NOCODE_Nori	Papua New Guinea
bly	Benin
blx	Philippines
blz	Indonesia (Papua)
blt	Australia	Viet Nam	France	United States	China	Laos	Thailand
blw	Philippines
blv	Angola
blq	Papua New Guinea
blp	Solomon Islands
bls	Indonesia (Papua)
blr	Thailand	China	Myanmar
blm	Sudan
bll	United States
blo	Togo	Benin
hca	India
bli	Democratic Republic of the Congo
blh	Liberia
blk	Thailand	Myanmar
blj	Indonesia (Papua)
ble	Gambia	Guinea-Bissau
bld	Indonesia (Papua)
blg	Malaysia (Peninsular)
blf	Indonesia (Papua)
bla	Canada	United States
blc	Canada
blb	Solomon Islands
onj	Papua New Guinea
onk	Papua New Guinea
oni	Indonesia (Papua)
onn	Papua New Guinea
ono	Canada	United States
onb	China
ona	Argentina
ong	Papua New Guinea
one	Canada	United States
onx	Indonesia (Papua)
onr	Papua New Guinea
ons	Papua New Guinea
onp	India
onw	Sudan
ont	Papua New Guinea
onu	Vanuatu
uky	Australia
ukw	Nigeria
uku	Nigeria
fmu	India
uks	Brazil
ukr	Brazil	Canada	Czech Republic	Lithuania	Slovakia	Argentina	Turkmenistan	Uzbekistan	Belarus	Armenia	Kazakhstan	Ukraine	Kyrgyzstan	Georgia	Poland	Moldova	United States	Latvia	Croatia	Romania	Estonia	Serbia	Azerbaijan	Russian Federation (Asia)	Paraguay	Hungary	Tajikistan
ukq	Nigeria
ukp	Nigeria
lnu	Nigeria
ukl	Ukraine
ukh	Central African Republic
ukg	Papua New Guinea
mks	United States	Mexico
uka	Indonesia (Papua)
NOCODE_Taimyr-Pidgin-Russian	Russia
rmb	Australia
rmc	Ukraine	Romania	Czech Republic	Poland	United States	Slovakia
rma	Nicaragua
lni	Papua New Guinea
rmg	Norway
sak	Gabon
saj	Indonesia (Papua)
sah	Russian Federation (Asia)
sao	Indonesia (Papua)
san	India
sam	Israel	Palestinian West Bank and Gaza
sac	United States
sab	Panama
saa	Chad
lnj	Australia
sag	Democratic Republic of the Congo	Congo	Central African Republic	Chad
saf	Ghana
sae	Brazil
sad	Tanzania
saz	India
say	Nigeria
sax	Vanuatu
rmk	Papua New Guinea
sas	Indonesia (Papua)
sar	Bolivia
saq	Kenya
sap	Paraguay
saw	Indonesia (Papua)
sav	Senegal
sau	Indonesia (Papua)
sat	Nepal	India	Bangladesh	Bhutan
zoc	Mexico
zoh	Mexico
rmn	Turkey (Asia)	Ukraine	Romania	Iran	Italy	Serbia	Macedonia	France	United States	Germany	Greece	Hungary	Moldova	Bulgaria
zom	India	Myanmar
zoo	Mexico
zoq	Mexico
zor	Mexico
zos	Mexico
lnb	Namibia
NOCODE_Milang	India
NOCODE_Caijia	China
axx	New Caledonia
sdf	Iraq
axb	Argentina
axg	Brazil
NOCODE_Litoka	Democratic Republic of the Congo
axk	Congo	Central African Republic
axl	Australia
qok	Cambodia
xml	Malaysia (Peninsular)
xmm	Indonesia (Papua)
xmo	Brazil
xmh	Australia
xmi	Brazil
xmj	Cameroon	Chad
xmd	Cameroon
xmf	Georgia
xmg	Cameroon
xma	Somalia
xmb	Cameroon
xmc	Mozambique
xmx	Indonesia (Papua)
xmy	Australia
xmz	Indonesia (Papua)
xmt	Indonesia (Papua)
xmu	Australia
xmv	Madagascar
xmw	Madagascar
xmp	Australia
xmq	Australia
xmr	Sudan
xms	Morocco
NOCODE_Meherrin	United States
wua	Australia
vkp	India
vkt	Indonesia (Papua)
vku	Australia
vki	Nigeria
vkj	Chad
vkk	Indonesia (Papua)
vkl	Indonesia (Papua)
vkm	Brazil
vko	Indonesia (Papua)
vka	Australia
NOCODE_Wenro	United States
kjb	United States	Guatemala
kjc	Indonesia (Papua)
kja	Indonesia (Papua)
kjf	Iran	Azerbaijan
kjg	Myanmar	Viet Nam	France	United States	China	Laos	Thailand
kjd	Papua New Guinea
kje	Indonesia (Papua)
kjj	Azerbaijan
kjk	Indonesia (Papua)
kjh	Russian Federation (Asia)	China
kji	Solomon Islands
kjn	Australia
kjo	India
kjl	Nepal
kjm	Viet Nam
kjr	Indonesia (Papua)
kjs	Papua New Guinea
kjp	Thailand	Myanmar
kjq	United States
kjt	Thailand
NOCODE_Dhudhuroa	Australia
kjz	Bhutan
kjx	Papua New Guinea
kjy	Papua New Guinea
zpy	Mexico
NOCODE_Khorasan-Arabic	Iran
zpz	Mexico
zpq	United States	Mexico
zpp	Mexico
zps	Mexico
zpr	Mexico
NOCODE_Ingain	Brazil
zpt	Mexico
zpw	Mexico
zpv	Mexico
zpi	Mexico
zph	Mexico
zpk	Mexico
zpj	Mexico
zpm	Mexico
zpl	Mexico
zpo	Mexico
zpn	Mexico
zpa	Mexico
zpc	Mexico
zpb	Mexico
zpe	Mexico
zpd	Mexico
zpg	Mexico
zpf	Mexico
uok	Nigeria
yzg	China
yzk	China
ygs	Australia
NOCODE_Lower-Darling-Lower-Lachlan	Australia
vum	Gabon
ivb	Philippines
ivv	Philippines
NOCODE_Degere	Kenya
vut	Nigeria	Cameroon
NOCODE_Southern-Inland-Yuin	Australia
NOCODE_Eastern-Khanty	Russian Federation (Asia)
mxp	Mexico
NOCODE_Zamuco	Paraguay	Bolivia
wpc	Venezuela
gdq	Kuwait	Yemen	Oman
gdr	Papua New Guinea
gds	Nepal
gdu	Nigeria
gdx	India
gda	India
gdb	India
gdc	Australia
gdd	Papua New Guinea
gde	Nigeria	Cameroon
gdf	Nigeria
gdg	Philippines
gdh	Australia
gdi	Central African Republic
gdj	Australia
gdk	Chad
gdl	Ethiopia
gdm	Chad
gdn	Papua New Guinea
gdo	Russian Federation (Asia)
NOCODE_Central-Southern-Persian-Gypsy	Iran
fvr	Sudan	Chad
NOCODE_Njanga	Nigeria
pos	Mexico
pok	Brazil
NOCODE_Alipur-Sign	India
tvy	East Timor
tvu	Cameroon
tvt	India
tvw	Indonesia (Papua)
tvs	Kenya
tvm	Indonesia (Papua)
tvl	Kiribati	Nauru	Fiji	New Zealand	Tuvalu
tvo	Indonesia (Papua)
tvn	Myanmar
tvk	Vanuatu
tve	Indonesia (Papua)
eze	Nigeria
tva	Solomon Islands
NOCODE_Yonggu-Biao	China
NOCODE_Alacalufe-Central	Argentina
NOCODE_Yelelihre	Brazil
jgo	Cameroon
dds	Mali
jgb	Democratic Republic of the Congo
ddw	Indonesia (Papua)
jge	Israel	Georgia
ddj	Australia
ddi	Papua New Guinea
ddo	Russian Federation (Asia)
ddn	Nigeria	Benin
ddg	East Timor
dde	Congo
ddd	Sudan
acc	Guatemala
acb	Nigeria
aca	Colombia
acf	Saint Lucia	France	Trinidad and Tobago	Guyana	Grenada	Dominica
ace	Indonesia (Papua)
acd	Ghana
ack	India
aci	India
ach	Sudan	Uganda
acn	China	Myanmar
acm	Turkey (Asia)	Jordan	Iraq	Iran	Syria
acl	India
acs	Brazil
acr	Guatemala
acq	Eritrea	Libya	Egypt	United Kingdom	Djibouti	Somalia	Kenya	Yemen
acp	Nigeria
acw	Eritrea	Saudi Arabia
acv	United States
acu	Peru	Ecuador
act	Netherlands
NOCODE_Ngadjuri	Australia
acz	Sudan
acy	Cyprus
acx	United Arab Emirates	Djibouti	Tanzania	Oman	Kenya
bjg	Guinea-Bissau
bjf	Israel
bje	China
NOCODE_Teushen	Chile
bjc	Papua New Guinea
bjb	Australia
bja	Democratic Republic of the Congo
bjo	Sudan	Democratic Republic of the Congo	Central African Republic
bjn	Indonesia (Papua)	Malaysia (Peninsular)
bjm	Iraq
bjl	Papua New Guinea
bjk	Papua New Guinea
bjj	India
bji	Ethiopia	Kenya
bjh	Papua New Guinea
bjw	Côte d'Ivoire
bjv	Chad
bju	Cameroon
bjt	Senegal
bjs	Barbados
bjr	Papua New Guinea
bjq	Madagascar
bjz	Papua New Guinea
bjy	Australia
bjx	Philippines
her	Namibia	Botswana
hed	Chad
heg	Indonesia (Papua)
hea	China
heb	Canada	United States	Israel	Australia	Panama	United Kingdom	Palestinian West Bank and Gaza	Germany
hem	Democratic Republic of the Congo
heh	Tanzania
hei	Canada
NOCODE_Sengmai	Myanmar
NOCODE_Molet	Papua New Guinea
uig	Turkey (Asia)	Afghanistan	Kyrgyzstan	Australia	Pakistan	Tajikistan	India	Saudi Arabia	Mongolia	United States	Uzbekistan	Germany	China	Taiwan	Kazakhstan
uis	Papua New Guinea
uiv	Nigeria	Cameroon
NOCODE_Pauxi	Brazil
NOCODE_Mofu-Gudur-Sign-Language	Cameroon
cpi	China
cpn	Ghana
cpa	Mexico
cpb	Brazil	Peru
cpc	Peru
cpg	Greece
cpx	Malaysia (Peninsular)	China	Singapore
cpy	Peru
cps	Philippines
cpu	Peru
mnx	Indonesia (Papua)
mny	Mozambique
mnz	Indonesia (Papua)
scn	Italy
sci	Sri Lanka
sch	India
sck	India
bvr	Australia
mnp	China	Singapore
mnq	Malaysia (Peninsular)
scg	Indonesia (Papua)
mns	Russian Federation (Asia)
mnt	Australia
bvq	Central African Republic
mnv	Solomon Islands
mnw	Thailand	Myanmar
mnh	Democratic Republic of the Congo
mni	India	Bangladesh	Myanmar
mnj	Afghanistan
mnk	Gambia	Senegal	Guinea-Bissau
mnl	Vanuatu
mnm	Papua New Guinea
mnn	Viet Nam
scu	India
mna	Papua New Guinea
mnb	Indonesia (Papua)
dsq	Algeria	Mali
scq	Cambodia
mne	Chad
mnf	Cameroon
qvi	Ecuador
zmj	Australia
smo	Tonga	Samoa	American Samoa	United States	New Zealand	Fiji
zmh	Papua New Guinea
zmi	Malaysia (Peninsular)
zmn	Congo	Gabon
zmo	Sudan
zml	Australia
smn	Finland
zmb	Democratic Republic of the Congo
zmc	Australia
zma	Australia
zmf	Democratic Republic of the Congo
zmg	Australia
zmd	Australia
zme	Australia
zmz	Democratic Republic of the Congo	Congo	Central African Republic
zmx	Congo	Central African Republic
zmy	Australia
bvz	Indonesia (Papua)
zmr	Australia
zms	Democratic Republic of the Congo
zmp	Democratic Republic of the Congo
zmq	Democratic Republic of the Congo
zmv	Australia
zmw	Democratic Republic of the Congo
zmt	Australia
zmu	Australia
dsi	Chad
pbu	Canada	Pakistan	Afghanistan	United Arab Emirates	India	United Kingdom	United States
pbt	Pakistan	Iran	Afghanistan	United Arab Emirates	United Kingdom	Tajikistan
dse	Netherlands
pbp	Guinea	Senegal	Guinea-Bissau
pbs	Mexico
pbr	Tanzania
smc	Papua New Guinea
pby	Papua New Guinea
pbz	Myanmar
pbe	Mexico
NOCODE_Shiwa	Gabon
pbg	Venezuela
pbf	Mexico
pbc	Guyana
pbb	Colombia
bvg	Cameroon
pbo	Senegal	Guinea-Bissau
pbn	Nigeria
pbi	Cameroon
pbh	Venezuela
bvf	Chad
kda	Australia
qmx	India
qvz	Peru	Ecuador
xow	Papua New Guinea
bvh	Nigeria
xor	Brazil
xop	Papua New Guinea
bvo	Chad
xog	Uganda
xod	Indonesia (Papua)
xoc	Nigeria
xon	Ghana	Togo
xoo	Brazil
xom	Sudan	Ethiopia
xok	Brazil
xoi	Papua New Guinea
NOCODE_KiKar	Kenya
NOCODE_Amorite	Syria
vic	Netherlands Antilles	U.S. Virgin Islands	British Virgin Islands
vif	Congo	Gabon
vig	Burkina Faso
vid	Tanzania
vie	Canada	Czech Republic	Vanuatu	Cambodia	France	Laos	Norway	United Kingdom	Australia	China	Martinique	Germany	Netherlands	Philippines	Finland	New Caledonia	United States	Thailand	Côte d'Ivoire	Viet Nam	Russian Federation (Asia)	Senegal	Taiwan
vin	Tanzania
vil	Argentina
vis	India
viv	Papua New Guinea
vit	Nigeria
NOCODE_Nawa	Brazil
kld	Australia
kle	Nepal	India
klf	Chad
klg	Philippines
kla	United States
klb	Mexico
klc	Cameroon
kll	Philippines
klm	Papua New Guinea
klo	Nigeria
klh	Papua New Guinea
kli	Indonesia (Papua)
klj	Iran
klk	Nigeria
klt	Papua New Guinea
klu	Ghana	Liberia	Nigeria	United States	Sierra Leone
klv	Vanuatu
klw	Indonesia (Papua)
klp	Papua New Guinea
klq	Papua New Guinea
klr	Nepal	India
isr	Israel
klx	Papua New Guinea
kly	Indonesia (Papua)
klz	Indonesia (Papua)
xug	Japan
xua	India
ism	Indonesia (Papua)
NOCODE_Atacame	Ecuador
ise	Italy
ito	Bolivia
itl	Russian Federation (Asia)
itm	Nigeria
itk	Italy
iti	Philippines
ite	Bolivia
itb	Philippines
ita	Brazil	Canada	Italy	San Marino	Malta	France	Somalia	Argentina	Israel	Australia	Slovenia	Germany	Bosnia and Herzegovina	Chile	Puerto Rico	Belgium	Eritrea	Libya	Philippines	Saudi Arabia	United States	Liechtenstein	Croatia	Luxembourg	Switzerland	Romania	Uruguay	Egypt	United Arab Emirates	Vatican State	South Africa	United Kingdom	Tunisia	Paraguay
NOCODE_Eudeve	Mexico
itx	Indonesia (Papua)
ity	Philippines
itv	Philippines
itw	Nigeria
itt	Philippines
itr	Papua New Guinea
its	Nigeria
kfs	India
wrg	Australia
wrd	Afghanistan
wrb	Australia
wra	Papua New Guinea
wrn	Sudan
wro	Australia
wrl	Australia
wrm	Australia
wrk	Australia
wrh	Australia
wri	Australia
wrv	Papua New Guinea
wrw	Australia
wru	Indonesia (Papua)
wrr	Australia
wrs	Indonesia (Papua)	Papua New Guinea
wrp	Indonesia (Papua)
wrz	Australia
wrx	Indonesia (Papua)
wry	India
tri	Brazil	Suriname
NOCODE_Bidai	United States
tro	India
NOCODE_Mayoruna-Jandiatuba	Brazil
gft	Ethiopia
trd	India
gfk	Papua New Guinea
xib	Spain
NOCODE_Tunumiisiut	Denmark	Greenland
NOCODE_Qujiang-Hakka-Shibei-Shaoguan-Tuhua	China
NOCODE_Syriem	India
NOCODE_Otomaco	Venezuela
jer	Nigeria
jet	Indonesia (Papua)	Papua New Guinea
jeu	Chad
jeb	Peru
jeg	Laos
jee	Nepal
jek	Côte d'Ivoire
jeh	Viet Nam	Laos
jei	Indonesia (Papua)
jen	Nigeria
jel	Indonesia (Papua)
NOCODE_Urucucus	Brazil
aae	Italy
aad	Papua New Guinea
aag	Papua New Guinea
aaf	India
aaa	Nigeria
aac	Papua New Guinea
aab	Nigeria
aam	Tanzania
aal	Nigeria	Cameroon
aao	Egypt	United States	Niger	Algeria
aan	Brazil
aai	Papua New Guinea
aah	Papua New Guinea
aak	Papua New Guinea
aau	Papua New Guinea
aat	Greece
aaw	Papua New Guinea
odk	Pakistan
aaq	United States
aap	Brazil
aas	Tanzania
aar	Eritrea	Djibouti	Ethiopia
aay	India
aax	Indonesia (Papua)
aaz	Indonesia (Papua)
bhi	India
bhh	United States	Uzbekistan	Israel
bhk	Philippines
bhj	Nepal
bhm	Oman	Yemen
bhl	Papua New Guinea
bho	Mauritius	Nepal	India
bhn	Russian Federation (Asia)	Georgia
bha	India
bhc	Indonesia (Papua)
bhb	India
bhe	Pakistan
bhd	India
bhg	Papua New Guinea
bhf	Papua New Guinea
bhy	Democratic Republic of the Congo
bhx	India
bhz	Indonesia (Papua)
oda	Nigeria
bhq	Indonesia (Papua)
bhp	Indonesia (Papua)
qpp	India
bhr	Madagascar
bhu	India
bht	India
bhw	Indonesia (Papua)
bhv	Indonesia (Papua)
NOCODE_Aruba	Aruba
hgw	Papua New Guinea
hgm	Namibia	Botswana	South Africa
NOCODE_Hiri-Motu-Trading-Eleman	Papua New Guinea
tpg	Indonesia (Papua)
tpf	Indonesia (Papua)
tpe	Bangladesh
tpc	Mexico
tpa	Papua New Guinea
tpo	Laos
tpn	Brazil
tpm	Ghana
tpl	Mexico
tpk	Brazil
tpj	Paraguay	Argentina	Bolivia
tpi	Papua New Guinea
tpw	Brazil
tpv	Northern Mariana Islands
ext	Portugal	Spain
tpt	Mexico
tpr	Brazil
tpq	India
tpp	Mexico
NOCODE_Kathlamet	United States
tpz	Papua New Guinea
tpy	Brazil
tpx	Mexico
ojv	Solomon Islands
ojw	Canada
ugo	Thailand
ugn	Uganda
ojp	Japan
ugb	Australia
uga	Israel
uge	Solomon Islands
ojg	Canada
ugy	Uruguay
ojb	Canada
ojc	Canada
NOCODE_Yimas-Iatmul-Pidgin	Papua New Guinea
NOCODE_Butam	Papua New Guinea
crr	United States
crs	Seychelles
crq	Paraguay	Argentina	Bolivia
crv	India
crw	Viet Nam
crt	Argentina
crz	United States
crx	Canada
cry	Nigeria
crb	Dominican Republic
crc	Vanuatu
cra	Ethiopia
crf	Colombia
crg	Canada	United States
crd	United States
crj	Canada
crk	Canada	United States
crh	Turkey (Asia)	Ukraine	Kyrgyzstan	Romania	Moldova	Russian Federation (Asia)	Uzbekistan	United States	Bulgaria
cri	São Tomé e Príncipe
crn	United States	Mexico
cro	United States
crl	Canada
crm	Canada
sew	Papua New Guinea
sev	Côte d'Ivoire
seu	Indonesia (Papua)
set	Indonesia (Papua)
ses	Mali
ser	United States
seq	Burkina Faso
sep	Côte d'Ivoire	Burkina Faso	Mali
sez	Myanmar
sey	Peru	Ecuador
seg	Tanzania
sef	Côte d'Ivoire
see	Canada	United States
sed	Viet Nam	Laos
sec	Canada
seb	Côte d'Ivoire
sea	Malaysia (Peninsular)
seo	Papua New Guinea
sen	Burkina Faso
sel	Russian Federation (Asia)
sek	Canada
sej	Papua New Guinea
sei	Mexico
seh	Mozambique
zko	Russian Federation (Asia)
zkk	United States
zkg	South Korea
zka	Indonesia (Papua)
zkb	Russian Federation (Asia)
NOCODE_Charrua	Uruguay
zkt	China
zku	Australia
zkp	Brazil
zkr	India
swt	Indonesia (Papua)
pdu	Thailand	Myanmar
pdt	Canada
pdo	Indonesia (Papua)
pdn	Indonesia (Papua)
sww	Vanuatu
pdi	Viet Nam	China
pdc	Canada	United States
pda	Papua New Guinea
NOCODE_Mansim	Indonesia (Papua)
xay	Indonesia (Papua)
xap	United States
xar	Papua New Guinea
xas	Russian Federation (Asia)
xat	Brazil
xau	Indonesia (Papua)
xav	Brazil
xaw	United States
xai	Brazil
xal	United States	Kyrgyzstan	Mongolia	Russian Federation (Asia)	Germany	China	Taiwan
xam	South Africa
xan	Ethiopia
xao	Viet Nam
xaa	Spain
xab	Nigeria
xac	India
xad	United States
xag	Azerbaijan
nri	India
nrm	Malaysia (Peninsular)
nrl	Australia
nrc	Slovenia
nrb	Eritrea
nra	Congo	Gabon
nrg	Vanuatu
nre	India
NOCODE_Batanta	Indonesia (Papua)
nrz	Papua New Guinea
nrx	Australia
nrr	Myanmar
nrp	Spain
nru	China
nrt	United States
mlb	Cameroon
mlc	Viet Nam
mla	Vanuatu
mlf	United States	Thailand	Laos
mld	Afghanistan
mle	Papua New Guinea
NOCODE_Kaishana	Brazil
mlk	Kenya
mlh	Papua New Guinea
mli	Indonesia (Papua)
mln	Solomon Islands
mlo	Senegal
mll	Vanuatu
mlm	China
mlr	Cameroon
mls	Sudan	Chad
mlp	Papua New Guinea
mlq	Gambia	Senegal	Guinea-Bissau	Mali
mlv	Vanuatu
mlw	Cameroon
mlt	Canada	United States	Australia	Italy	Libya	Tunisia	Malta	United Kingdom
mlu	Solomon Islands
mlz	Philippines
mlx	Vanuatu
NOCODE_Xinca-Guazacapan	Guatemala
psh	Afghanistan
vot	Russian Federation (Asia)
amj	Chad
vor	Nigeria
psn	Indonesia (Papua)
pso	Poland
amo	Nigeria
NOCODE_Korapun-Bromley	Papua New Guinea
amn	Papua New Guinea
NOCODE_Goo	C\^ote d'Ivoire
NOCODE_Cuitlatec	Mexico
lxu	China
amb	Nigeria
rdb	Iran
amg	Australia
NOCODE_Caspian-Eastern-Persia-Gypsy	Iran
amf	Ethiopia
knn	India
kno	Sierra Leone
knl	Indonesia (Papua)
knm	Brazil
knj	United States	Guatemala	Mexico
knk	Guinea	Sierra Leone
kni	Nigeria
knf	Gambia	Senegal	Guinea-Bissau
kng	Democratic Republic of the Congo	Congo	Angola
knd	Indonesia (Papua)
kne	Philippines
knb	Philippines
knc	Eritrea	Chad	Sudan	Niger	Cameroon	Nigeria
kna	Nigeria
psy	United States
knz	Burkina Faso	Mali
knx	Indonesia (Papua)	Malaysia (Peninsular)
kny	Democratic Republic of the Congo
knv	Papua New Guinea
knw	Namibia	Angola	South Africa
knt	Brazil
knu	Guinea
knr	Papua New Guinea
kns	Thailand	Malaysia (Peninsular)
knp	Cameroon
knq	Thailand	Malaysia (Peninsular)
psr	Portugal
amp	Papua New Guinea
psp	Philippines
amr	Peru
amt	Papua New Guinea
pst	Pakistan
amv	Indonesia (Papua)
NOCODE_Sakhalin-Ainu	Japan
NOCODE_Amam	Papua New Guinea
ijs	Nigeria
NOCODE_Kurmin-Dangana	Nigeria
ijc	Nigeria
ije	Nigeria
ijj	Benin
ijn	Nigeria
NOCODE_Lebu	Senegal
chc	United States
NOCODE_Mango	China
NOCODE_Geico	Brazil
NOCODE_Matanawi	Brazil
NOCODE_Sacata	Peru
NOCODE_Bruny-Island	Australia
NOCODE_Nisvai	Indonesia (Papua)
cic	United States
cib	Benin
cia	Indonesia (Papua)
cie	Nigeria
cid	United States
cik	India
cih	India
cin	Brazil
cim	Italy
cir	New Caledonia
cip	Mexico
ciw	United States
ciy	Venezuela
pfa	Micronesia
sxb	Kenya
sxe	Gabon
sxg	China
sxk	United States
sxm	Cambodia
sxn	Indonesia (Papua)	Philippines
sxr	Taiwan
sxs	Nigeria
sxu	Germany
sxw	Benin
jct	Ukraine
jcs	Jamaica
qud	Ecuador
ago	Papua New Guinea
agn	Philippines
agm	Papua New Guinea
agl	Papua New Guinea
agk	Philippines
agj	Ethiopia
agi	India
agh	Democratic Republic of the Congo
agg	Papua New Guinea
agf	Indonesia (Papua)
age	Papua New Guinea
agd	Papua New Guinea
agc	Nigeria
agb	Nigeria
aga	Peru
agz	Philippines
agy	Philippines
agx	Russian Federation (Asia)	Azerbaijan
agw	Solomon Islands
agv	Philippines
agu	Guatemala
agt	Philippines
ags	Nigeria	Cameroon
agr	Peru
agq	Cameroon
qvl	Peru
qvm	Peru
qvn	Peru
qvo	Peru	Ecuador	Colombia
bvw	Nigeria
bvv	Venezuela
qvj	Ecuador
bvt	Indonesia (Papua)
qve	Peru
bvy	Philippines
bvx	Congo
qva	Peru
qvc	Peru
bvc	Solomon Islands
bvb	Equatorial Guinea
bva	Chad
NOCODE_Yamasee	United States
qvy	China
bve	Indonesia (Papua)
bvd	Solomon Islands
bvk	Indonesia (Papua)
bvj	Nigeria
bvi	Sudan
qvw	Peru
qvp	Peru
bvn	Papua New Guinea
bvm	Cameroon
qvs	Peru
qui	United States
NOCODE_Binahari-Ma	Papua New Guinea
quh	Argentina	Bolivia
gvp	Brazil
evh	Nigeria
trh	Papua New Guinea
trj	Chad
trm	Afghanistan
trl	United Kingdom	United States	Australia
evn	Russian Federation (Asia)	United States	China	Mongolia
trn	Bolivia
tra	Afghanistan
trc	United States	Mexico
trb	Papua New Guinea
tre	Indonesia (Papua)
eve	Russian Federation (Asia)
trg	Israel	Georgia	Azerbaijan
trf	Trinidad and Tobago
try	India
trx	Indonesia (Papua)	Malaysia (Peninsular)
trz	Brazil
trq	Mexico
trp	India	Bangladesh
trs	Mexico
trr	Peru
tru	Brazil	Canada	Australia	Lebanon	Turkey (Asia)	United States	Sweden	Netherlands	Germany	Belgium	Syria	Argentina	Iraq
trt	Indonesia (Papua)
trw	Pakistan
trv	Taiwan
nmv	Australia
nmw	Papua New Guinea
odt	Netherlands
odu	Nigeria
tdh	Nepal	India
tdo	Nigeria
ues	Indonesia (Papua)
nms	Vanuatu
NOCODE_Mwesa	Gabon
tdl	Nigeria
lea	Democratic Republic of the Congo
leb	Democratic Republic of the Congo	Zambia
lec	Bolivia
led	Democratic Republic of the Congo	Uganda
lee	Burkina Faso
lef	Ghana
leg	Paraguay
leh	Zambia
lei	Papua New Guinea
lej	Democratic Republic of the Congo
lek	Papua New Guinea
lel	Democratic Republic of the Congo
lem	Cameroon
len	El Salvador	Honduras
leo	Cameroon
lep	Nepal	India	Bhutan
leq	Papua New Guinea
ler	Papua New Guinea
les	Democratic Republic of the Congo
let	Papua New Guinea
leu	Papua New Guinea
lev	Indonesia (Papua)
lew	Indonesia (Papua)
lex	Indonesia (Papua)
ley	Indonesia (Papua)
lez	Turkey (Asia)	Ukraine	Kyrgyzstan	Georgia	Turkmenistan	Azerbaijan	Russian Federation (Asia)	Uzbekistan	Kazakhstan
tdd	Myanmar	France	China	Laos	Switzerland	Thailand
ctt	India
ctu	Mexico
ctp	Mexico
cts	Philippines
nmd	Gabon
ctz	Mexico
ctd	India	Myanmar
cte	Mexico
ctg	Bangladesh
cta	Mexico
ctc	United States
ctl	Mexico
ctm	United States
ctn	Nepal
cto	Panama	Colombia
cti	Mexico
sgx	Sierra Leone
sgz	Papua New Guinea
sgp	India
sgr	Iran
sgu	Indonesia (Papua)
sgt	Bhutan
sgw	Ethiopia
sgi	Cameroon
sgh	Afghanistan	Tajikistan
sgk	China
sgm	Uganda
sgl	Afghanistan	Tajikistan
sgo	Democratic Republic of the Congo
nmo	India
sga	Ireland
sgc	Kenya
sgb	Philippines
sge	Indonesia (Papua)
sgd	Philippines
sgg	Switzerland
ziw	Tanzania
zir	Nigeria
ziz	Nigeria	Cameroon
nmk	Vanuatu
zib	Zimbabwe
tdu	Malaysia (Peninsular)
zia	Papua New Guinea
zin	Tanzania
zil	Liberia
zim	Chad
zik	Papua New Guinea
NOCODE_Ooku	Papua New Guinea
dza	Nigeria
pfe	Nigeria	Cameroon
pfl	Germany
NOCODE_Wagu	Papua New Guinea
dzd	Nigeria
NOCODE_Tiverighotto	Venezuela
NOCODE_Payagua	Paraguay
xcc	Italy
xcg	Italy
xce	Spain
xch	United States
xcn	Mexico
xco	Uzbekistan
xcl	Armenia
xcm	Mexico
xcr	Turkey (Asia)
xcv	Russian Federation (Asia)
xcw	United States
xct	China
dzn	Democratic Republic of the Congo
bow	Papua New Guinea
NOCODE_Basum	China
NOCODE_Port-Sorell	Australia
xcy	United States
npl	Mexico
npo	India
npn	Papua New Guinea
npi	Nepal
nph	India
npa	Nepal
afn	Nigeria
npb	Bhutan
npy	Indonesia (Papua)
npu	India
nps	Indonesia (Papua)
gcd	Australia
mjd	United States
mje	Chad
mjg	China
mja	China
mjc	Mexico
mjl	India
mjm	Papua New Guinea
mjn	Papua New Guinea
mjo	India
mjh	Tanzania
mji	Viet Nam	China	Laos
mjj	Papua New Guinea
mjk	Papua New Guinea
mjt	India	Bangladesh
mju	India
mjv	India
mjw	India
mjp	India
mjq	India
mjr	India
mjs	Nigeria
mjx	India
mjy	United States
mjz	Nepal	India
vml	Australia
vmm	Mexico
vmj	Mexico
vmk	Mozambique
vmh	Iran
vmi	Australia
vmf	Germany
vmg	Papua New Guinea
vmd	India
vme	Indonesia (Papua)
vmb	Australia
vmc	Mexico
vma	Australia
vmz	Mexico
vmx	Mexico
vmy	Mexico
vmv	United States
vmw	Mozambique
vmu	Australia
vmr	Mozambique
vms	Indonesia (Papua)
vmp	Mexico
vmq	Mexico
NOCODE_Yoruba-Sign	Nigeria
lzz	Turkey (Asia)	Georgia	France	United States	Germany	Belgium
NOCODE_Duit	Colombia
lzh	China
lzl	Vanuatu
lzn	Myanmar
kpp	Myanmar
kpq	Indonesia (Papua)
kpr	Papua New Guinea
kps	Indonesia (Papua)
kpt	Russian Federation (Asia)
kpu	Indonesia (Papua)
kpv	Russian Federation (Asia)
kpw	Papua New Guinea
kpx	Papua New Guinea
kpy	Russian Federation (Asia)
kpz	Uganda
dje	Nigeria	Niger	Burkina Faso	Mali
kpa	Nigeria
kpb	India
kpc	Brazil	Venezuela	Colombia
kpd	Indonesia (Papua)
kpf	Papua New Guinea
kpg	Micronesia
kph	Ghana
kpi	Indonesia (Papua)
kpj	Brazil
kpk	Nigeria
kpl	Democratic Republic of the Congo
kpm	United States	Viet Nam
kpn	Brazil
kpo	Ghana	Togo
NOCODE_Lianmin-Yao	China
NOCODE_Kawarrang-Ogh-Undjan	Australia
NOCODE_Poya	Argentina
NOCODE_Hiri-Motu-Trading-Koriki	Papua New Guinea
cll	Ghana
loj	Papua New Guinea
ihp	Indonesia (Papua)
ihw	Australia
ihi	Nigeria
ihb	Indonesia (Papua)
NOCODE_Manao	Brazil
NOCODE_Agbirigba	Nigeria
qwc	Peru
otk	Mongolia
mnd	Brazil
cke	Guatemala
ckd	Guatemala
ckf	Guatemala
cka	Myanmar
ckc	Guatemala
ckb	Iraq	Iran
ckl	Nigeria
cko	Ghana	Togo	Benin
cki	Guatemala
ckh	Bangladesh	Myanmar
ckk	Guatemala
ckj	Guatemala
cku	United States
ckt	Russian Federation (Asia)
ckw	Guatemala
ckv	Taiwan
ckq	Chad
cks	New Caledonia
ckr	Papua New Guinea
NOCODE_Dharumbal	Australia
cky	Nigeria
ckx	Cameroon
ckz	Guatemala
dbi	Nigeria
dbj	Malaysia (Peninsular)
szn	Indonesia (Papua)
dbl	Australia
dbo	Nigeria
dbn	Indonesia (Papua)
szb	Indonesia (Papua)	Papua New Guinea
szc	Malaysia (Peninsular)
dbb	Nigeria
dbe	Indonesia (Papua)
dbd	Nigeria
szd	Malaysia (Peninsular)
sze	Ethiopia
dby	Papua New Guinea
dbq	Nigeria	Cameroon
dbp	Nigeria
szp	Indonesia (Papua)
dbr	Somalia
szv	Cameroon
szw	Indonesia (Papua)
dbw	Mali
dbv	Nigeria
irh	Indonesia (Papua)
jaz	New Caledonia
jax	Indonesia (Papua)
jay	Australia
jav	United States	Indonesia (Papua)	Netherlands	Malaysia (Peninsular)	Singapore
NOCODE_Gangou	China
jat	Afghanistan
jau	Indonesia (Papua)
jar	Nigeria
jas	New Caledonia
jaq	Indonesia (Papua)
jao	Australia
jal	Indonesia (Papua)
jam	Canada	Jamaica	Panama	Costa Rica	United Kingdom	Dominican Republic	United States
jaj	Solomon Islands
jak	Malaysia (Peninsular)
jah	Malaysia (Peninsular)
jai	Guatemala	Mexico
jaf	Nigeria
jad	Guinea	Mali
jae	Papua New Guinea
jab	Nigeria
jac	Guatemala
jaa	Brazil
NOCODE_Karruwali	Australia
NOCODE_Sapara	Brazil
NOCODE_Tangam	India
lbm	India
gbf	Papua New Guinea
gbg	Democratic Republic of the Congo	Central African Republic
gbd	Australia
aer	Australia
gbb	Australia
gbc	Australia
aew	Papua New Guinea
gbn	Sudan
gbo	Liberia
gbl	India
gbm	India
gbj	India
gbk	India
gbh	Benin
gbi	Indonesia (Papua)
gbv	Central African Republic
aec	Egypt
aeb	Belgium	Tunisia	Germany	Libya	France
aee	Afghanistan
aed	Argentina
gbp	Central African Republic
gbq	Central African Republic
aek	New Caledonia
gbz	Iran
ael	Cameroon
gbx	Benin
aen	Armenia
btu	Nigeria
btt	Nigeria
btw	Philippines
btv	Pakistan	India
btq	Malaysia (Peninsular)
btp	Papua New Guinea
bts	Indonesia (Papua)
btr	Vanuatu
bty	Indonesia (Papua)
btx	Indonesia (Papua)
btz	Indonesia (Papua)
bte	Nigeria
btd	Indonesia (Papua)
btg	Côte d'Ivoire
btf	Chad
bta	Nigeria	Cameroon
NOCODE_Colima	Colombia
btc	Cameroon
btb	Cameroon
btm	Indonesia (Papua)
btl	India
bto	Philippines
btn	Philippines
bti	Indonesia (Papua)
bth	Indonesia (Papua)	Malaysia (Peninsular)
btj	Indonesia (Papua)
etr	Papua New Guinea
ets	Nigeria
tlq	Myanmar	Laos
tlp	Mexico
tlw	Indonesia (Papua)
tlv	Indonesia (Papua)
ett	Italy
NOCODE_Lawu	China
etz	Indonesia (Papua)
tlz	Indonesia (Papua)
etx	Nigeria
tlx	Papua New Guinea
tlc	Mexico
tlb	Indonesia (Papua)
tla	Mexico
tlg	Indonesia (Papua)
tlf	Papua New Guinea
tld	Indonesia (Papua)
tlk	Indonesia (Papua)
tlj	Democratic Republic of the Congo	Uganda
tli	Canada	United States
NOCODE_Lawi	Laos
tlo	Sudan
tln	Indonesia (Papua)
tlm	Vanuatu
tll	Democratic Republic of the Congo
NOCODE_Burundi-Pidgin-French	Burundi
NOCODE_Ben-Lomond-Cape-Portland	Australia
lgk	Vanuatu
lgh	Viet Nam
lgi	Indonesia (Papua)
lgn	Sudan	Ethiopia
tsx	Papua New Guinea
lgl	Solomon Islands
lgm	Democratic Republic of the Congo
lgb	Solomon Islands
lga	Solomon Islands
lgg	Democratic Republic of the Congo	Uganda
NOCODE_Tarairiu	Brazil
lgz	Democratic Republic of the Congo
NOCODE_Demushbo	Brazil
lgr	Solomon Islands
lgq	Ghana
lgt	Papua New Guinea
lgu	Solomon Islands
NOCODE_Tembey	Brazil
cvn	Mexico
tsp	Burkina Faso
cvg	India
rbb	China	Myanmar
qws	Peru
dad	Papua New Guinea
NOCODE_Quepos	Costa Rica
NOCODE_Guaru	Colombia
NOCODE_Zhongu	China
zgr	Papua New Guinea
NOCODE_Dorasque	Colombia
zgm	China
zgn	China
zga	Tanzania
zgb	China
phk	India
phh	Viet Nam	China
pho	Thailand	Laos
phn	Tunisia
phm	Mozambique
phl	Pakistan
pha	Viet Nam	China
phg	Viet Nam
phd	India
phr	Pakistan
phq	Laos
phw	Nepal
phv	Afghanistan
phu	Thailand	Laos
pht	United States	Thailand	Viet Nam	Laos
ofo	United States
ofs	Netherlands
unn	Australia
ofu	Nigeria
xed	Nigeria	Cameroon
xeg	South Africa
xeb	Iraq
xel	Sudan
xem	Indonesia (Papua)
xet	Brazil
xeu	Papua New Guinea
xer	Brazil
xes	Papua New Guinea
NOCODE_Lenca-Salvador	El Salvador
wec	Côte d'Ivoire
wea	Myanmar
wed	Papua New Guinea
wei	Papua New Guinea
weh	Cameroon
weo	Indonesia (Papua)
wem	Benin
wes	Cameroon
wer	Papua New Guinea
wep	Germany
wew	Indonesia (Papua)
weu	Myanmar
wet	Indonesia (Papua)
nvo	Cameroon
nvm	Papua New Guinea
nvh	Vanuatu
mhn	Italy
mho	Namibia	Zambia	Angola
mhl	Papua New Guinea
mhm	Mozambique
mhj	Afghanistan
mhk	Cameroon
mhh	Paraguay
mhi	Sudan	Uganda
mhf	Papua New Guinea
mhg	Australia
mhd	Tanzania
mhe	Malaysia (Peninsular)
mhb	Gabon
mhc	Mexico
mha	India
mhz	Indonesia (Papua)
mhx	China	Myanmar
mhy	Indonesia (Papua)
mhw	Namibia	Zambia	Angola	Botswana
mht	Brazil	Venezuela
mhu	India	China
mhr	Russian Federation (Asia)	Kazakhstan
mhs	Indonesia (Papua)	Netherlands
mhp	Indonesia (Papua)
mhq	United States
vsv	Spain
vsi	Moldova
vsl	Venezuela
NOCODE_Kjachta-Pidgin	Russia
krz	Indonesia (Papua)
krx	Gambia	Senegal
kry	Azerbaijan
krr	Cambodia
krs	Sudan	Central African Republic
krp	Nigeria	Cameroon
krv	Cambodia
krw	Liberia	Côte d'Ivoire
krt	Niger
kru	India	Bangladesh	Bhutan
krj	Philippines
krk	Russian Federation (Asia)
krh	Nigeria
kri	United States	Gambia	Senegal	Sierra Leone	Guinea
krn	Liberia
krl	Russian Federation (Asia)	Finland
krm	Sierra Leone
krb	United States
krc	United States	Kyrgyzstan	Azerbaijan	Russian Federation (Asia)	Uzbekistan	Armenia	Kazakhstan
kra	Nepal
krf	Vanuatu
krd	East Timor
kre	Brazil
yri	Colombia
yrk	Russian Federation (Asia)
yrl	Brazil	Venezuela	Colombia
yrn	China
yra	Papua New Guinea
yrb	Papua New Guinea
yre	Côte d'Ivoire
yrs	Indonesia (Papua)
yrw	Papua New Guinea
inz	United States
int	Myanmar
inp	Peru
ins	Pakistan	India	Bangladesh
inl	Indonesia (Papua)
inm	Yemen
inn	Philippines
ino	Papua New Guinea
inh	Russian Federation (Asia)	Uzbekistan
NOCODE_Papuan-Pidgin-English	Papua New Guinea
inj	Colombia
ind	Saudi Arabia	Netherlands	Singapore	Philippines	United States	Indonesia (Papua)
ing	United States
ina	France
inb	Venezuela	Colombia
hps	United States
mch	Brazil	Venezuela
mcg	Venezuela
hpo	Myanmar
wxa	China
NOCODE_Enga-Sign	Papua New Guinea
mcb	Peru
tmb	Vanuatu
NOCODE_Yadhaykenu	Australia
eot	Côte d'Ivoire
aln	Romania	Albania	Czech Republic	Serbia	Montenegro	Macedonia	United States	Slovenia	Bulgaria
alo	Indonesia (Papua)
mcu	Cameroon
pti	Australia
pth	Brazil
reb	Indonesia (Papua)
cmo	Viet Nam	Cambodia
cmn	Canada	Brunei	United States	Libya	Singapore	Viet Nam	Philippines	Malaysia (Peninsular)	Cambodia	Zambia	United Kingdom	Indonesia (Papua)	China	Mongolia	Laos	Russian Federation (Asia)	Mozambique	Taiwan	Mauritius	Thailand
cml	Indonesia (Papua)
cmk	United States
cmi	Colombia
cme	Côte d'Ivoire	Burkina Faso
cma	Viet Nam
cwd	Canada
cmt	South Africa
cms	Italy
cmr	Myanmar
quq	Spain
alx	Papua New Guinea
qup	Peru
bwr	Nigeria
qur	Peru
alw	Ethiopia
bwt	Cameroon
ptu	Indonesia (Papua)
bwu	Ghana
ptt	Indonesia (Papua)
quv	Guatemala
als	Turkey (Asia)	Ukraine	Albania	Egypt	United States	Sweden	Croatia	Greece	Belgium	Germany
bwx	China
bwy	Burkina Faso
ptp	Papua New Guinea
NOCODE_Bindal-Cunningham	Australia
NOCODE_Cypriot-Greek	Cyprus
glh	Afghanistan
akz	United States
glj	Chad
glk	Iran
glo	Nigeria
aks	Togo
akr	Vanuatu
akq	Papua New Guinea
akp	Ghana
gld	Russian Federation (Asia)	China
gle	Brazil	Canada	United States	United Kingdom	Ireland
aku	Nigeria	Cameroon
akt	Papua New Guinea
akk	Iraq
akj	India
aki	Papua New Guinea
akh	Papua New Guinea
ako	Suriname
akm	India
akl	Philippines
akc	Indonesia (Papua)
akb	Indonesia (Papua)
aka	Ghana
akg	Indonesia (Papua)
akf	Nigeria
glv	United Kingdom
glw	Nigeria	Cameroon
brz	Papua New Guinea
bry	Papua New Guinea
brx	Nepal	India
brw	India
brv	United States	Thailand
bru	Viet Nam	Laos
quf	Peru
brs	Indonesia (Papua)
brr	Solomon Islands
brq	Papua New Guinea
brp	Indonesia (Papua)
bro	Bhutan
brn	Costa Rica
brm	Democratic Republic of the Congo
brl	Botswana	South Africa
brk	Sudan
brj	Vanuatu
bri	Cameroon
brh	Afghanistan	Iran	Turkmenistan	Pakistan
brg	Bolivia
brf	Democratic Republic of the Congo
bre	United States	France
brd	Nepal
brc	Guyana
brb	United States	Laos	Viet Nam	Cambodia	France
bra	India
quj	Guatemala
qum	Guatemala
bwm	Papua New Guinea
bwo	Ethiopia
nka	Zambia
nkb	India
nkc	Cameroon
nkd	India
nke	Solomon Islands
nkf	India
nkg	Papua New Guinea
nkh	India
nki	India
nkj	Indonesia (Papua)
nkk	Vanuatu
nkm	Papua New Guinea
nkn	Angola
nko	Ghana
nkp	Tonga
nkr	Micronesia
nks	Indonesia (Papua)
nkt	Tanzania
nku	Ghana	Côte d'Ivoire
nkv	Zambia	Malawi
nkw	Democratic Republic of the Congo
nkx	Nigeria
nkz	Nigeria
tmo	Malaysia (Peninsular)
ert	Indonesia (Papua)
tnt	Indonesia (Papua)
tnw	Indonesia (Papua)
tnv	Bangladesh
tnq	Bahamas
tnp	Vanuatu
err	Australia
ers	China
tny	Tanzania
tnx	Solomon Islands
tnz	Thailand	Malaysia (Peninsular)
tne	Philippines
tnd	Colombia
tng	Chad
tnf	Afghanistan
tna	Bolivia
era	India
tnc	Colombia
tnb	Colombia
tnm	Indonesia (Papua)
tnl	Vanuatu
tno	Bolivia
ero	China
erh	Nigeria
eri	Papua New Guinea
tnk	Vanuatu
erk	Vanuatu
uar	Papua New Guinea
fay	Iran
uam	Brazil
uan	Laos
sse	Philippines
lal	Democratic Republic of the Congo
lam	Democratic Republic of the Congo	Zambia
lan	Nigeria
lao	Canada	Australia	Cambodia	France	United States	Laos	Thailand
lai	Tanzania	Malawi	Zambia
laj	Uganda
lak	Nigeria
lad	Turkey (Asia)	United States	Israel	Puerto Rico	Greece
lae	India
laf	Sudan
lag	Tanzania
laa	Philippines
lac	Mexico
lax	India
lay	Myanmar
laz	Papua New Guinea
lat	Vatican State
lau	Indonesia (Papua)
lav	Brazil	Canada	Belarus	Estonia	Venezuela	Lithuania	Latvia	United Kingdom	United States	Sweden	Australia	Germany	Russian Federation (Asia)	New Zealand	Ukraine
law	Indonesia (Papua)
lap	Central African Republic	Chad
laq	Viet Nam	China
lar	Ghana
las	Ghana	Togo	Benin
zea	Netherlands
zeg	Papua New Guinea
zeh	China
zen	Mauritania	Senegal
ssf	Taiwan
NOCODE_Jupua	Colombia
NOCODE_Basque-Amerindian-Pidgin	Papua New Guinea
pjt	Australia
xgb	C\^ote d'Ivoire
xga	Turkey (Asia)
xgu	Australia
wgg	Australia
wga	Australia
wgb	Papua New Guinea
wgo	Indonesia (Papua)
wgi	Papua New Guinea
wgu	Australia
wgy	Australia
nty	Viet Nam
ntz	Iran
ntp	Mexico
nts	Colombia
ntr	Ghana	Togo
ntu	Solomon Islands
ntw	United States
nti	Burkina Faso
NOCODE_Tunisian-Zuwara	Tunisia
ntk	Tanzania
ntj	Australia
ntm	Benin
nto	Democratic Republic of the Congo
NOCODE_Pidgin-Herschel-Eskimo	United States
nte	Mozambique
mvp	Indonesia (Papua)
mvq	Papua New Guinea
mvr	Indonesia (Papua)
mvs	Indonesia (Papua)
mvt	Vanuatu
mvu	Chad
mvv	Indonesia (Papua)	Malaysia (Peninsular)
mvw	Tanzania
mvx	Indonesia (Papua)
mvy	Pakistan
mvz	Ethiopia
mva	Papua New Guinea
mvb	United States
mvc	Guatemala
mvd	Indonesia (Papua)
mve	Pakistan
mvf	China	Mongolia
mvg	Mexico
mvh	Chad
mvi	Japan
mvj	Guatemala	Mexico
mvk	Papua New Guinea
mvl	Australia
mvm	China
mvn	Papua New Guinea
mvo	Solomon Islands
NOCODE_Ngardi	Australia
nbx	Australia
NOCODE_Dume	Ethiopia
nbr	Nigeria
teb	Ecuador
tec	Kenya
ted	Liberia	Côte d'Ivoire
NOCODE_Jitotolteco	Mexico
nbv	Cameroon
nbu	India
nbt	India
nbk	Papua New Guinea
ktx	Brazil
kty	Democratic Republic of the Congo
ktz	Namibia	Botswana
tey	Sudan
ktt	Indonesia (Papua)
ktu	Democratic Republic of the Congo
ktv	Viet Nam
ktw	United States
ktp	China	Laos
ktq	Philippines
ktr	Malaysia (Peninsular)
kts	Indonesia (Papua)
ktl	Iran
ktm	Papua New Guinea
ktn	Brazil
kto	Papua New Guinea
kth	Chad
kti	Indonesia (Papua)
ktj	Côte d'Ivoire
ktk	Papua New Guinea
ktd	Australia
kte	Nepal
ktf	Democratic Republic of the Congo
ktg	Australia
kta	Viet Nam
ktb	Ethiopia
ktc	Nigeria
NOCODE_Pidgin-Chinook-Jargon	Canada	United States
teq	Sudan
ter	Brazil
ypp	China
lbo	United States	Laos
ypz	China
nbg	India
nbf	China
ypb	China
ypa	China
ypg	China
yph	China
tew	United States
ypn	China
ypo	China
ypm	China
NOCODE_Buena-Vista-Yokuts	United States
oge	Georgia
NOCODE_West-Taa	Namibia
hrx	Brazil	Paraguay	Argentina	Chile	Uruguay
hrz	Iran
hru	India
hrt	Turkey (Asia)
hrv	Canada	Slovakia	Italy	Czech Republic	Serbia	Montenegro	United States	Slovenia	Austria	Germany	Bosnia and Herzegovina	Chile	Hungary	Croatia
hrr	Indonesia (Papua)
hrm	China
hro	Viet Nam
ogc	Nigeria
hrk	Indonesia (Papua)
hre	Viet Nam
ogb	Nigeria
hra	India	Myanmar
eme	French Guiana
emg	Nepal
ema	Nigeria
NOCODE_Harappan	Pakistan
emb	Indonesia (Papua)
eml	San Marino	Italy
emo	Paraguay
emn	Cameroon
emi	Papua New Guinea
emk	Guinea	Sierra Leone	Liberia
suz	Nepal
emu	India
emw	Indonesia (Papua)
emp	Panama	Colombia
ems	United States
emy	Mexico
emx	France
NOCODE_Winjarumi	Australia
NOCODE_Passe	Brazil
NOCODE_Gueren	Brazil
haj	India	Bangladesh
bnx	Democratic Republic of the Congo
coq	United States
ilg	Australia
cos	Canada	Italy	Cuba	Uruguay	France	United States	Puerto Rico	Bolivia	Venezuela
cor	United Kingdom
ilb	Zambia
cot	Peru
cow	United States
ila	Indonesia (Papua)
coy	Colombia
ilo	United States	Philippines
ill	Malaysia (Peninsular)
coz	Mexico
ilk	Philippines
ili	Kazakhstan	China
coa	Australia	Malaysia (Peninsular)
ilw	Indonesia (Papua)
coc	United States	Mexico
ilu	Indonesia (Papua)
coe	Colombia
ils	United States
cog	Thailand	Cambodia
bnr	Vanuatu
coh	Kenya
cok	Mexico
coj	Mexico
com	United States
col	United States
coo	Canada
con	Ecuador	Colombia
hac	Iraq	Iran
had	Indonesia (Papua)
hae	Ethiopia
NOCODE_Haraza	Sudan
haf	Viet Nam
hax	Canada
hay	Tanzania
haz	Tajikistan	Afghanistan	Iran	Pakistan
NOCODE_Curetu	Colombia
haq	Tanzania
har	Ethiopia
gnr	Australia
gnq	Malaysia (Peninsular)
aiy	Central African Republic
gnw	Bolivia
gnt	Papua New Guinea
gnu	Papua New Guinea
gnz	Central African Republic
ait	Brazil
aiw	Ethiopia
aiq	Tajikistan	Afghanistan	Iran
aip	Indonesia (Papua)
ais	Taiwan
air	Indonesia (Papua)
gnb	India	Myanmar
gnc	Spain
aio	India
ain	Japan
aii	Brazil	Canada	Italy	France	Georgia	Turkey (Asia)	Russian Federation (Asia)	Australia	Iran	Germany	Armenia	Belgium	Iraq	Netherlands	United States	Sweden	Switzerland	Syria	New Zealand	Lebanon	Azerbaijan	United Kingdom	Austria	Greece	Cyprus
aih	China
aik	Nigeria
gne	Nigeria
aie	Papua New Guinea
aid	Australia
aig	Montserrat	Saint Kitts and Nevis	United Kingdom	Antigua and Barbuda	Anguilla	Dominica
haw	United States
aia	Solomon Islands
gno	India
gnl	Australia
gnm	Papua New Guinea
NOCODE_Vili	Gabon
NOCODE_Pidgin-Carib	Guyana
gni	Australia
nij	Indonesia (Papua)
nik	India
nih	Tanzania	Zambia
nii	Papua New Guinea
nin	Nigeria
nio	Russian Federation (Asia)
nil	Indonesia (Papua)
nim	Tanzania
nib	Papua New Guinea
nia	Indonesia (Papua)
NOCODE_Imunga-Trade	Papua New Guinea
nig	Australia
nid	Australia
nie	Chad
niz	Papua New Guinea
nix	Democratic Republic of the Congo
niy	Democratic Republic of the Congo
nir	Indonesia (Papua)
nis	Papua New Guinea
niq	Kenya
niv	Russian Federation (Asia)
niw	Papua New Guinea
nit	India
niu	Tonga	United States	New Zealand	Niue	Cook Islands
thz	Niger
thy	Nigeria
thx	Laos
thw	Nepal
thv	Niger	Libya	Algeria
thu	Sudan
tht	Canada
ths	Nepal
thr	Nepal	India
thq	Nepal	India
thp	Canada
thn	India
thm	Thailand	Laos
thl	Nepal	India
thk	Kenya
thi	Laos
epi	Nigeria
thf	India	Nepal	China
the	Nepal	India
thd	Australia
thc	Viet Nam
tha	Canada	United Arab Emirates	United States	Thailand	Singapore
NOCODE_Tsixa	Botswana
lcs	Indonesia (Papua)
lcp	Thailand
rnl	India
rna	Colombia
rng	Mozambique	South Africa
rnd	Democratic Republic of the Congo	Angola
lcf	Indonesia (Papua)
lcd	Indonesia (Papua)
lce	Indonesia (Papua)
lcc	Indonesia (Papua)
lcl	Indonesia (Papua)
rnp	India
rnw	Tanzania
lch	Namibia	Zambia	Angola
bpa	Vanuatu
qxc	Peru
qxa	Peru
bpd	Sudan	Central African Republic
bpg	Indonesia (Papua)
bpi	Papua New Guinea
bph	Russian Federation (Asia)
qxh	Peru
bpj	Democratic Republic of the Congo
qxn	Peru
qxo	Peru
qxl	Ecuador
bpn	China
qxr	Ecuador
qxs	China
qxp	Peru
qxq	Iran
bpu	Papua New Guinea
bpt	Australia
qxt	Peru
bpv	Indonesia (Papua)
bpy	India	Bangladesh	Myanmar
bpx	India
bpz	Indonesia (Papua)
zca	Mexico
zch	China
yka	Philippines	Malaysia (Peninsular)
ykg	Russian Federation (Asia)
ykk	Papua New Guinea
yki	Indonesia (Papua)
yko	Gabon	Cameroon	Equatorial Guinea
ykn	China
ykm	Papua New Guinea
ykl	China
ykr	Papua New Guinea
NOCODE_Pauxiana	Brazil
yku	China
ykt	China
yky	Democratic Republic of the Congo	Central African Republic
plw	Philippines
plv	Philippines
plu	Brazil	French Guiana
plt	United States	Madagascar	Réunion	Comoros
pls	Mexico
plr	Côte d'Ivoire
plq	Turkey (Asia)
plp	Nepal
plz	Malaysia (Peninsular)
ply	China
plg	Argentina
ple	Indonesia (Papua)
pld	United Kingdom
plc	Philippines
plb	Vanuatu
pla	Papua New Guinea
plo	Mexico
pln	Colombia
NOCODE_Northern-Sunraysia	Australia
pll	China	Myanmar
plk	Pakistan
plj	Nigeria
pli	India	Myanmar
plh	Indonesia (Papua)
obo	Philippines
obl	Cameroon
obm	Jordan
obi	United States
obu	Nigeria
obr	Myanmar
NOCODE_Guale	United States
xyy	Australia
xya	Australia
xyl	Brazil
wao	United States
wan	Côte d'Ivoire
wam	United States
wal	Ethiopia
waj	Papua New Guinea
wai	Indonesia (Papua)
wah	Indonesia (Papua)
wag	Papua New Guinea
waf	Brazil
wae	Switzerland	Austria	Italy	Liechtenstein
wad	Indonesia (Papua)
wac	United States
wab	Papua New Guinea
waa	United States
waz	Papua New Guinea
way	Brazil	French Guiana	Suriname
wax	Papua New Guinea
waw	Brazil	Guyana
wav	Nigeria
wau	Brazil
wat	Papua New Guinea
was	United States
war	Philippines
waq	Australia
wap	Brazil	Guyana
NOCODE_Quillacinga	Colombia
mtz	Guatemala	Mexico
mtx	Mexico
mty	Papua New Guinea
mtr	India
mts	Peru
mtp	Argentina	Bolivia
mtq	Viet Nam
mtv	Papua New Guinea
mtw	Philippines
mtt	Vanuatu
mtu	Mexico
mtj	Indonesia (Papua)
mtk	Cameroon
mth	Indonesia (Papua)
mti	Papua New Guinea
mtn	Nicaragua
mto	Mexico
mtl	Nigeria
mtm	Russian Federation (Asia)
mtb	Côte d'Ivoire
mtc	Papua New Guinea
mta	Philippines
mtf	Papua New Guinea
mtg	Indonesia (Papua)
mtd	Indonesia (Papua)
mte	Solomon Islands
vwa	China
NOCODE_Gutian	Iran
kvf	Chad
kvg	Papua New Guinea
kvd	Indonesia (Papua)
NOCODE_Mikaya-Bambengangale-Baluma	Congo
kvb	Indonesia (Papua)
kvc	Papua New Guinea
kva	Russian Federation (Asia)
kvn	Panama	Colombia
kvo	Indonesia (Papua)
kvl	Myanmar
kvm	Cameroon
kvj	Nigeria	Cameroon
kvk	Korea	South
kvh	Indonesia (Papua)
kvi	Chad
kvv	Indonesia (Papua)
kvw	Indonesia (Papua)
kvt	Myanmar
kvu	Myanmar
kvr	Bahrain	Indonesia (Papua)
kvs	Australia
kvp	Indonesia (Papua)
kvq	Myanmar
kvz	Indonesia (Papua)
kvx	Pakistan
kvy	Myanmar
ums	Indonesia (Papua)
umr	Australia
NOCODE_Kokenop-Mandobo	Indonesia (Papua)
dbm	Nigeria
yvt	Venezuela
szl	Poland
NOCODE_Old-Wanji	Afghanistan
dba	Mali
jvn	French Guiana	Suriname
jvd	Indonesia (Papua)
sza	Malaysia (Peninsular)
NOCODE_Chapakura	Bolivia
szg	Democratic Republic of the Congo
dbg	Mali
dbf	Indonesia (Papua)
fon	Togo	Benin
guc	Venezuela	Colombia
gub	Brazil
gua	Nigeria
gug	Paraguay	Argentina
guf	Australia
gue	Australia
gud	Côte d'Ivoire
guk	Sudan	Ethiopia
guj	Canada	Mauritius	Réunion	Bangladesh	Pakistan	Oman	Tanzania	Singapore	India	South Africa	Malawi	United Kingdom	United States	Zimbabwe	Mozambique	Uganda	Kenya	Fiji	Botswana	Zambia
gui	Paraguay	Argentina	Bolivia
guh	Venezuela	Colombia
guo	Colombia
gun	Brazil	Paraguay	Argentina	Uruguay
gum	Colombia
gul	United States
gus	Guinea
gur	Ghana	Burkina Faso
guq	Paraguay
gup	Australia
guw	Nigeria	Benin
guv	Cameroon
guu	Brazil	Venezuela
gut	Costa Rica
guz	Kenya	Tanzania
gux	Togo	Niger	Burkina Faso	Benin
hto	Colombia
NOCODE_Zhangzhung	China
hti	Indonesia (Papua)
htu	Indonesia (Papua)
hts	Tanzania
NOCODE_South-Australian-Pidgin-English	Australia
dbu	Mali
dbt	Mali
cwb	Mozambique
eko	Mozambique
ekm	Cameroon
ekl	Bangladesh
eki	Nigeria
ekg	Indonesia (Papua)
eke	Nigeria
ekb	China
eka	Nigeria
eky	Thailand	Myanmar
ekr	Nigeria
ekp	Nigeria
uzn	Turkey (Asia)	Ukraine	Israel	Australia	Turkmenistan	Tajikistan	Uzbekistan	Kyrgyzstan	Russian Federation (Asia)	United States	China	Kazakhstan
uzs	Turkey (Asia)	Afghanistan	Pakistan
NOCODE_Pidgin-Hawaiian	United States
ksg	Solomon Islands
ibi	Nigeria
cay	Canada	United States
cax	Bolivia
ibl	Philippines
ibm	Nigeria
ibn	Nigeria
ibo	Nigeria
cas	Bolivia
car	Brazil	Venezuela	French Guiana	Suriname	Guyana
ibb	Nigeria
cap	Bolivia
caw	Bolivia
cav	Bolivia
ibg	Philippines
cak	Guatemala
caj	Bolivia
cah	Peru
cao	Bolivia
can	Papua New Guinea
cam	New Caledonia
cal	Northern Mariana Islands
cac	Guatemala
cab	United States	Nicaragua	Guatemala	Belize	Honduras
ibr	Nigeria
cag	Paraguay	Argentina
caf	Canada
cae	Senegal
cad	United States
spy	Kenya
spp	Mali
spq	Peru
spr	Indonesia (Papua)
sps	Papua New Guinea
spt	India
spu	Laos
NOCODE_Mpalityan-Lutigh	Australia
spk	Papua New Guinea
spl	Papua New Guinea
spm	Papua New Guinea
spo	United States
spa	Canada	U.S. Virgin Islands	Panama	Costa Rica	Morocco	France	Andorra	Aruba	Gibraltar	Peru	Argentina	Bolivia	Norway	Ecuador	Israel	Australia	Cuba	El Salvador	Venezuela	Guatemala	Germany	Chile	Puerto Rico	Belgium	Dominican Republic	Belize	Spain	Cayman Islands	Trinidad and Tobago	Philippines	Finland	United States	Netherlands Antilles	Sweden	Uruguay	Switzerland	Anguilla	Jamaica	Honduras	Equatorial Guinea	Mexico	Colombia	Paraguay	Nicaragua
spb	Indonesia (Papua)
spc	Venezuela
spd	Papua New Guinea
spe	Papua New Guinea
spg	Malaysia (Peninsular)
NOCODE_Tombidi	Gabon
aog	Papua New Guinea
aof	Papua New Guinea
aoe	Papua New Guinea
aod	Papua New Guinea
aoc	Brazil	Venezuela	Guyana
aob	Papua New Guinea
aoa	São Tomé e Príncipe
aon	Papua New Guinea
aom	Papua New Guinea
aol	Indonesia (Papua)
aok	New Caledonia
aoj	Papua New Guinea
aoi	Australia
aoh	Colombia
aou	China
aot	India	Bangladesh
aos	Indonesia (Papua)
aor	Vanuatu
aoz	Indonesia (Papua)
aox	Brazil	Guyana
ght	Nepal
ghr	Pakistan
ghs	Papua New Guinea
ghe	Nepal
gha	Tunisia	Libya
ghc	United Kingdom
ghl	Sudan
ghn	Solomon Islands
gho	Morocco
ghh	Nepal
ghk	Myanmar
soa	Thailand
soc	Democratic Republic of the Congo
NOCODE_Guyambal	Australia
sob	Indonesia (Papua)
NOCODE_Yimas-Alamblak-Pidgin	Papua New Guinea
sod	Democratic Republic of the Congo
sog	Uzbekistan
mbk	Papua New Guinea
soi	Nepal
soh	Sudan
sok	Chad
tja	Liberia
nom	Brazil	Peru
non	Norway
noo	Canada
noh	Papua New Guinea
noi	India
noj	Chile
nok	United States
tji	China
noe	India
nof	Papua New Guinea
nog	Russian Federation (Asia)	Uzbekistan	Kazakhstan
tjm	United States
noa	Panama	Colombia
tjo	Algeria
noc	Papua New Guinea
tjs	China
gbe	Papua New Guinea
tju	Australia
mbb	Philippines
noz	Ethiopia
not	Peru
nou	Papua New Guinea
now	Tanzania
nop	Papua New Guinea
noq	Democratic Republic of the Congo
nor	Norway
nos	China
aey	Papua New Guinea
sou	Thailand
sot	Lesotho	Botswana	Swaziland	South Africa
aez	Papua New Guinea
sow	Indonesia (Papua)	Papua New Guinea
NOCODE_Damu	China
soy	Togo	Benin
mbu	Nigeria
NOCODE_Dama	Sierra Leone
aea	Australia
mbw	Papua New Guinea
gbu	Australia
gbr	Nigeria
gbs	Benin
lmx	Cameroon
lmy	Indonesia (Papua)
lmz	United States
lmp	Nigeria	Cameroon
lmq	Indonesia (Papua)
lmr	Indonesia (Papua)
NOCODE_Ulterior-Mixe	Mexico
lmu	Vanuatu
lmv	Fiji
lmw	United States
lmh	Nepal
lmi	Democratic Republic of the Congo
lmj	Indonesia (Papua)
lmk	India	Myanmar
lml	Vanuatu
lmm	Cambodia
lmn	India
lmo	Switzerland	United States	Italy
lma	Guinea	Sierra Leone
lmb	Vanuatu
lmc	Australia
lmd	Sudan
lme	Cameroon	Chad
lmf	Indonesia (Papua)
lmg	Papua New Guinea
aem	Viet Nam	Laos
gby	Nigeria
NOCODE_Orkon	Vanuatu
zao	Mexico
zal	China
zam	Mexico
zaj	Tanzania
zak	Tanzania
zah	Nigeria
zai	Mexico
zaf	Mexico
zag	Sudan	Chad	Libya
NOCODE_Muellamues	Colombia
zae	Mexico
zab	United States	Mexico
zac	Mexico
zaa	Mexico
zaz	Nigeria
zax	Mexico
zay	Ethiopia
zav	United States	Mexico
zaw	Mexico
zat	Mexico
zau	India
zar	Mexico
zas	Mexico
zaq	Mexico
yig	China
yif	China
yia	Australia
yim	India
yil	Australia
yin	Myanmar
yii	Australia
yih	Israel	Netherlands	France	Switzerland	Germany	Belgium	Hungary
yik	China
yij	Australia
yiu	China
yit	China
yiv	China
yiq	China
yip	China
yis	Papua New Guinea
yir	Indonesia (Papua)
yiy	Australia
yix	China
yiz	China
pny	Cameroon
pnx	Laos
pnz	Nigeria	Cameroon	Central African Republic	Chad
pnq	Burkina Faso	Mali
pnp	Indonesia (Papua)
pns	Indonesia (Papua)
pnr	Papua New Guinea
pnu	China
pnt	Canada	Turkey (Asia)	Georgia	Azerbaijan	Russian Federation (Asia)	United States	Greece	Kazakhstan
pnw	Australia
pnv	Australia
pni	Indonesia (Papua)
pnh	Cook Islands
pnm	Malaysia (Peninsular)
pnl	Burkina Faso
pno	Peru
pnn	Papua New Guinea
pna	Malaysia (Peninsular)
pnc	Indonesia (Papua)
pnb	Canada	Pakistan	Afghanistan	United Arab Emirates	India	United Kingdom	United States
pne	Malaysia (Peninsular)
png	Nigeria
wca	Brazil
NOCODE_Ghardaia-Sign-Language	Algeria
wci	Togo	Benin
mrx	Indonesia (Papua)
mry	Philippines
mrz	Indonesia (Papua)
NOCODE_Southern-Coastal-Yuin	Australia
mrt	Nigeria
mru	Cameroon
mrv	French Polynesia
mrw	Philippines
mrp	Vanuatu
mrq	Micronesia
mrr	India
mrs	Vanuatu
mrl	Micronesia
mrm	Vanuatu
mrn	Solomon Islands
mro	India	Bangladesh	Myanmar
mrh	India	Myanmar
mri	United States	New Zealand
mrj	Russian Federation (Asia)
mrk	New Caledonia
mrd	Nepal
mre	United States
mrf	Indonesia (Papua)
mrg	India
mra	Thailand	Laos
mrb	Vanuatu
mrc	United States
NOCODE_Ngumbarl	Australia
NOCODE_Xoco	Brazil
NOCODE_Afghanistan-Gorbati	Afghanistan
NOCODE_WW2-Pidgin-German	Germany
kxh	Ethiopia
kxi	Malaysia (Peninsular)
kxj	Chad
kxk	Myanmar
kxl	Nepal
kxm	Thailand
kxn	Malaysia (Peninsular)
kxo	Brazil
kxa	Papua New Guinea
kxb	Côte d'Ivoire
kxc	Ethiopia
kxd	Brunei	Malaysia (Peninsular)
kxe	Nigeria
kxf	Myanmar
kxx	Congo
kxy	Viet Nam
kxz	Papua New Guinea
kxp	Pakistan	India
kxq	Indonesia (Papua)
kxr	Papua New Guinea
kxs	China
kxt	Papua New Guinea
kxu	India
kxv	India
kxw	Papua New Guinea
NOCODE_Monqui	Mexico
NOCODE_Gamella	Brazil
ytw	Papua New Guinea
mff	Cameroon
ytp	China
ytl	China
yta	China
jib	Nigeria
gwe	Tanzania
gwd	Ethiopia
gwg	Nigeria
gwf	Pakistan
gwa	Côte d'Ivoire
gwc	Pakistan
gwb	Nigeria
vun	Tanzania
gwn	Nigeria
gwi	Canada	United States
gwj	Botswana
gwu	Australia
gwt	Afghanistan	Pakistan
gww	Australia
gwr	Uganda
gwx	Ghana
hvk	New Caledonia
mfi	Nigeria	Cameroon
hvn	Indonesia (Papua)
hva	Mexico
hvc	Haiti
hve	Mexico
hvv	Mexico
tls	Vanuatu
tlr	Solomon Islands
NOCODE_Wuthathi	Australia
NOCODE_Early-East-African-Pidgin-Arabic	Uganda
eip	Indonesia (Papua)
eit	Papua New Guinea
eiv	Papua New Guinea
etu	Nigeria	Cameroon
NOCODE_Western-Coastal-Tasmanian	Australia
tly	Russian Federation (Asia)	Iran	Azerbaijan
etb	Nigeria
NOCODE_Mawakwa	Venezuela
NOCODE_Pacahuaras-Castillo	Bolivia
NOCODE_Kajana-Sign	Suriname
eth	Ethiopia
etn	Vanuatu
ccq	Myanmar
ccp	India	Bangladesh
eto	Cameroon
ccm	Malaysia (Peninsular)
ccl	Kenya	Tanzania
cco	Mexico
cch	Nigeria
ccj	Guinea-Bissau
cce	Mozambique
ccd	Brazil
ccg	Nigeria
cca	Colombia
ccc	Peru
ami	Taiwan
amh	Israel	Egypt	Sweden	United States	Ethiopia	Djibouti
amk	Indonesia (Papua)
psi	Afghanistan
amm	Papua New Guinea
aml	India	Bangladesh
psl	Puerto Rico
psm	Bolivia
ama	Brazil
psc	Iran
amc	Brazil	Peru
psa	Indonesia (Papua)
ame	Peru
psg	Malaysia (Peninsular)
psd	Canada	United States
pse	Indonesia (Papua)
amy	Australia
amx	Australia
amz	Australia
bsk	Pakistan	India
amq	Indonesia (Papua)
pss	Papua New Guinea
ams	Japan
psq	Papua New Guinea
amu	Mexico
psw	Vanuatu
amw	Syria
psu	India
gju	Afghanistan	India	Pakistan
gjn	Ghana
gjk	Pakistan	India
gji	Nigeria
NOCODE_Changuena	Colombia
ife	Togo	Benin
idi	Papua New Guinea
tdk	Nigeria
tdj	Indonesia (Papua)
nmt	Micronesia
nmu	United States
nmr	Cameroon
tdn	United States	Indonesia (Papua)
nmp	Australia
nmq	Zimbabwe	Botswana
tdc	Colombia
tdb	India
tda	Niger
nmz	Ghana	Togo
tdf	Laos
nmx	Papua New Guinea
nmy	China
nmf	India
nmg	Cameroon	Equatorial Guinea
tdy	Philippines
nme	India
nmb	Vanuatu
nmc	Central African Republic	Chad
nma	India
nmn	Namibia	Botswana
tdr	Viet Nam
nml	Cameroon
nmm	Nepal
nmj	Central African Republic
tdv	Nigeria
nmh	India
nmi	Nigeria
srb	India
src	Italy
sra	Papua New Guinea
srf	Papua New Guinea
srg	Philippines
dzg	Niger	Chad
sre	Indonesia (Papua)
srk	Malaysia (Peninsular)
srh	China
sri	Brazil	Colombia
srn	Netherlands Antilles	Netherlands	Aruba	Suriname
dzl	Bhutan
srl	Indonesia (Papua)
srm	French Guiana	Suriname
srr	Gambia	Senegal
srs	Canada
srp	Canada	Czech Republic	Turkey (Asia)	Australia	Zambia	Montenegro	Bosnia and Herzegovina	Ukraine	Libya	Macedonia	United States	Sweden	Croatia	Switzerland	Bulgaria	Romania	Albania	United Arab Emirates	Serbia	Russian Federation (Asia)	Greece	Hungary
srq	Bolivia
srv	Philippines
srw	Indonesia (Papua)
srt	Indonesia (Papua)
sru	Brazil
srz	Iran
srx	India
sry	Papua New Guinea
lob	Ghana	Côte d'Ivoire	Burkina Faso
loc	Philippines
loa	Indonesia (Papua)
lof	Sudan
log	Democratic Republic of the Congo
loe	Indonesia (Papua)
NOCODE_Mangree	C\^ote d'Ivoire
lok	Sierra Leone
loh	Sudan
loi	Côte d'Ivoire
lon	Malawi
loo	Democratic Republic of the Congo
lol	Democratic Republic of the Congo
lom	Liberia
lor	Côte d'Ivoire	Burkina Faso
los	Papua New Guinea
lop	Nigeria
loq	Democratic Republic of the Congo
lov	Myanmar
low	Malaysia (Peninsular)
lot	Sudan
lou	United States
loz	Zambia	Zimbabwe	Namibia	Botswana
lox	Indonesia (Papua)
loy	Nepal
rjs	Nepal
rjg	Indonesia (Papua)
rji	Nepal
NOCODE_Gwara	Nigeria
yon	Papua New Guinea
yom	Democratic Republic of the Congo	Congo	Angola
yol	Ireland
yok	United States
yoi	Japan
yog	Philippines
yob	Papua New Guinea
yoy	Thailand	Laos
yox	Japan
NOCODE_Baazem	Cameroon
yot	Nigeria
yos	Myanmar
yor	United States	United Kingdom	Togo	Nigeria	Sierra Leone	Benin
NOCODE_Malibu	Colombia
hnn	Philippines
NOCODE_Nzadi	Democratic Republic of the Congo
wms	Indonesia (Papua)
wmw	Mozambique
wmt	Australia
gla	Canada	United Kingdom	Australia	United States
wmi	Australia
wmh	East Timor
wmo	Papua New Guinea
wmn	New Caledonia
wmm	Indonesia (Papua)
wmc	Papua New Guinea
wmb	Australia
wma	Nigeria
wme	Nepal
wmd	Brazil
mpf	Guatemala
mpg	Chad
mpd	Brazil	Bolivia
mpe	Ethiopia
mpb	Australia
mpc	Australia
mpa	Tanzania
mpn	Papua New Guinea
mpo	Papua New Guinea
mpl	Papua New Guinea
mpm	Mexico
mpj	Australia
mpk	Chad
mph	Australia
mpi	Nigeria	Cameroon	Chad
mpv	Papua New Guinea
mpw	Brazil	Guyana
mpt	Papua New Guinea
mpu	Brazil
mpr	Solomon Islands
mps	Papua New Guinea
mpp	Papua New Guinea
mpq	Brazil
mpz	Thailand
mpx	Papua New Guinea
mpy	Indonesia (Papua)
pum	Nepal
nbj	Australia
puo	Viet Nam	Laos
asv	Democratic Republic of the Congo
puj	Indonesia (Papua)
puk	Laos
asz	Indonesia (Papua)
puf	Indonesia (Papua)
kzr	Cameroon	Chad
kzs	Malaysia (Peninsular)
kzp	Indonesia (Papua)
kzq	Nepal
kzv	Indonesia (Papua)
kzw	Brazil
kzt	Malaysia (Peninsular)
kzu	Indonesia (Papua)
kzz	Indonesia (Papua)
kzx	Indonesia (Papua)
kzy	Democratic Republic of the Congo
kzb	Indonesia (Papua)
kzc	Ghana	Côte d'Ivoire
kza	Burkina Faso
kzf	Indonesia (Papua)
kzg	Japan
kzd	Indonesia (Papua)
kze	Papua New Guinea
kzj	Malaysia (Peninsular)
kzk	Solomon Islands
kzh	Egypt	Sudan
kzi	Indonesia (Papua)	Malaysia (Peninsular)
kzn	Mozambique	Malawi
kzo	Gabon
kzl	Indonesia (Papua)
kzm	Indonesia (Papua)
pux	Papua New Guinea
puy	United States
NOCODE_Maang	China
ase	Canada	Madagascar	Democratic Republic of the Congo	Nigeria	Bolivia	Burkina Faso	Benin	Ghana	Singapore	Togo	Zimbabwe	China	Mauritania	Philippines	Central African Republic	United States	Gabon	Côte d'Ivoire	Jamaica	Chad	Kenya	Barbados
jra	United States	Viet Nam	Cambodia
NOCODE_Kilen	China
put	Indonesia (Papua)
jru	Venezuela
jrt	Nigeria
jrr	Nigeria
puu	Congo	Gabon
ash	Peru
aso	Papua New Guinea
puq	Peru
asm	United States	India	Bangladesh	Bhutan
vec	Brazil	Italy	Croatia	Slovenia
nbc	India
gqn	Brazil
gqi	China
gqa	Nigeria
gqu	China
gqr	Chad
hhr	Senegal
hhy	Papua New Guinea
NOCODE_Gardiol	Italy
hhi	Papua New Guinea
NOCODE_Yaroame	Brazil
mfy	Mexico
cjk	Namibia	Democratic Republic of the Congo	Zambia	Angola
NOCODE_New-Caledonian-Pidgin-French	New Caledonia
egy	Egypt
NOCODE_Antioquian	Colombia
ego	Nigeria
egl	Italy
ega	Côte d'Ivoire
NOCODE_American-Indian-Pidgin-English	United States
nbe	India
uvh	Papua New Guinea
ffm	Ghana	Côte d'Ivoire	Mali
uvl	Papua New Guinea
uve	New Caledonia
NOCODE_Hauna	Papua New Guinea
ceg	Paraguay
rwa	Papua New Guinea
ceb	United States	Philippines
cea	United States
cen	Nigeria
rwk	Tanzania
rwm	Democratic Republic of the Congo	Uganda
rwo	Papua New Guinea
rwr	Pakistan	Nepal	India
cet	Nigeria
ces	Canada	Ukraine	Israel	Czech Republic	Poland	Serbia	Romania	United States	Austria	Croatia	Slovakia	Bulgaria
ifu	Philippines
ify	Philippines
did	Sudan
iff	Vanuatu
ifa	Philippines
ifb	Philippines
ifm	Congo
ifk	Philippines
NOCODE_Daman-Diu-Portuguese	India
NOCODE_New-River-Shasta	United States
NOCODE_Pa-Na	China
NOCODE_Lizu	China
ass	Cameroon
asr	India
asq	Austria
asp	Algeria
asw	Australia
pui	Venezuela	Colombia
asu	Brazil
ast	Portugal	Spain
pud	Indonesia (Papua)
pue	Argentina
asy	Indonesia (Papua)
pug	Burkina Faso
pua	United States	Mexico
pub	Myanmar
puc	Indonesia (Papua)
asc	Indonesia (Papua)
asb	Canada	United States
asa	Tanzania
asg	Nigeria
asf	Australia
puz	India
asd	Papua New Guinea
ask	Afghanistan
asj	Cameroon
asi	Indonesia (Papua)
puw	Micronesia
pup	Papua New Guinea
asn	Brazil
pur	Brazil
asl	Indonesia (Papua)
NOCODE_Tongva	United States
ncx	Mexico
tfo	Indonesia (Papua)
tfn	United States
tfi	Benin
ncp	Cameroon
ncr	Cameroon
ncs	Nicaragua
nct	India
ncu	Ghana
nch	Mexico
nci	Mexico
ncj	Mexico
nck	Australia
ncl	Mexico
ncm	Papua New Guinea
ncn	Papua New Guinea
nco	Papua New Guinea
tft	Indonesia (Papua)
ncb	India
ncc	Papua New Guinea
ncd	Nepal
nce	Papua New Guinea
ncf	Papua New Guinea
ncg	Canada
std	India
ste	Indonesia (Papua)
stf	Papua New Guinea
stg	Viet Nam
sta	Zambia
stb	Philippines
stc	Solomon Islands
stl	Netherlands
stm	Papua New Guinea
stn	Solomon Islands
sto	Canada
sth	United Kingdom	United States	Ireland
sti	Viet Nam	Cambodia
stj	Burkina Faso	Mali
dtd	Canada
stt	Viet Nam
stu	Thailand	China	Myanmar	Laos
stv	Ethiopia
stw	Micronesia
stp	Mexico
stq	Germany
str	Canada	United States
sts	Afghanistan
dts	Mali
dtr	Malaysia (Peninsular)
dtp	Malaysia (Peninsular)
dtu	Mali
dtt	Mali
ncz	United States
lid	Papua New Guinea
lie	Democratic Republic of the Congo
lif	Nepal	India	Bhutan
lig	Ghana	Côte d'Ivoire
lia	Sierra Leone
lib	Papua New Guinea
lic	China
lil	Canada
lim	Belgium	Netherlands	Germany
lin	Democratic Republic of the Congo	Congo	Central African Republic
lio	Indonesia (Papua)
lih	Papua New Guinea
lii	Nepal
lij	Monaco	Italy	France
lik	Democratic Republic of the Congo
lit	Brazil	Canada	Kyrgyzstan	Belarus	Turkmenistan	Estonia	Uruguay	Tajikistan	Poland	Lithuania	Uzbekistan	Latvia	United Kingdom	United States	Sweden	Australia	Russian Federation (Asia)	Argentina	Kazakhstan
liu	Sudan
liv	Latvia
liw	Indonesia (Papua)
lip	Ghana
liq	Ethiopia
lir	Liberia
lis	India	China	Myanmar	Thailand
lix	Indonesia (Papua)
liy	Central African Republic
liz	Democratic Republic of the Congo
kac	United States	China	Myanmar
kab	Belgium	Algeria	France
kaa	Afghanistan	Kyrgyzstan	Turkmenistan	Russian Federation (Asia)	Uzbekistan	Kazakhstan
NOCODE_Balade	New Caledonia
kag	Malaysia (Peninsular)
kaf	China
kae	Taiwan
kad	Nigeria
kak	Philippines
rhp	Papua New Guinea
kai	Nigeria
kah	Central African Republic
kao	Gambia	Senegal	Mali
kan	Canada	United States	India
kam	Kenya
kal	Denmark	Greenland
kas	United Kingdom	Pakistan	United States	India
kaq	Peru
kap	Russian Federation (Asia)
kaw	Indonesia (Java and Bali)
kav	Brazil
kat	Turkey (Asia)	Ukraine	Kyrgyzstan	Georgia	Iran	Turkmenistan	Tajikistan	Uzbekistan	Azerbaijan	Russian Federation (Asia)	United States	Armenia	Kazakhstan
kaz	Turkey (Asia)	Afghanistan	Kyrgyzstan	Iran	Turkmenistan	Tajikistan	Uzbekistan	Mongolia	Russian Federation (Asia)	United States	Germany	China	Kazakhstan	Ukraine
kay	Brazil
kax	Indonesia (Papua)
rhg	Thailand	Saudi Arabia	Malaysia (Peninsular)	Bangladesh	Myanmar
bzw	Nigeria
bzv	Cameroon
bzu	Indonesia (Papua)
bzs	Brazil
bzr	Australia
bzq	Indonesia (Papua)
bzp	Indonesia (Papua)
NOCODE_Bindal-Mount-Elliot	Australia
bzy	Nigeria
bzx	Mali
bzg	Taiwan
bzf	Papua New Guinea
qbb	Italy
bzd	Costa Rica
bzc	Madagascar
bzb	Indonesia (Papua)
bza	Guinea	Liberia
bzo	Democratic Republic of the Congo
bzn	Indonesia (Papua)
bzm	Democratic Republic of the Congo
bzl	Indonesia (Papua)
NOCODE_Chacha	Peru
bzj	United States	Belize
bzi	Thailand	China	Myanmar
bzh	Papua New Guinea
nca	Papua New Guinea
ymq	China
ymp	Papua New Guinea
ymr	India
ymx	China
ymz	China
yma	Nepal
ymc	China
ymb	Papua New Guinea
yme	Peru
ymd	China
ymg	Democratic Republic of the Congo
ymi	China
ymh	China
ymk	Tanzania	Mozambique
tfr	Panama	Costa Rica
ymm	Sudan	Ethiopia	United States	Somalia	Kenya
yml	Papua New Guinea
ymo	Papua New Guinea
ymn	Indonesia (Papua)
dtk	Mali
dti	Mali
NOCODE_Paunaca	Bolivia
dtm	Burkina Faso	Mali
dtb	Malaysia (Peninsular)
dta	China	Mongolia
stk	Papua New Guinea
woy	Ethiopia
wow	Indonesia (Papua)
dty	Nepal
wos	Papua New Guinea
wor	Indonesia (Papua)
wom	Nigeria
wol	Mauritania	Gambia	France	Senegal	Guinea-Bissau	Mali
woo	Indonesia (Papua)
won	Democratic Republic of the Congo
woi	Indonesia (Papua)
wok	Cameroon
woe	Micronesia
wod	Indonesia (Papua)
wog	Papua New Guinea
wof	Gambia
woa	Australia
woc	Papua New Guinea
wob	Côte d'Ivoire
NOCODE_Mondzi	China
adu	Nigeria
adr	Indonesia (Papua)
NOCODE_Xinka-Jumaytepeque	Guatemala
gmn	Cameroon
gmm	Cameroon
gml	Germany
NOCODE_Bangru	India
gmd	Nigeria
gmy	Greece
gmx	Tanzania
NOCODE_Dolakha-Newari	Nepal
boz	Mali
hbn	Sudan
iya	Nigeria
iyo	Cameroon
gmu	Papua New Guinea
boq	Papua New Guinea
iyx	Congo
jpn	Brazil	Canada	Palau	Northern Mariana Islands	Panama	Micronesia	Argentina	Australia	Singapore	American Samoa	Germany	Thailand	Dominican Republic	Belize	Philippines	United States	Mongolia	New Zealand	Mexico	United Arab Emirates	Guam	United Kingdom	Paraguay	Japan	Taiwan
jpa	Israel
bot	Sudan
NOCODE_Tanpachoa	Mexico
jpr	Israel	Iran
bon	Papua New Guinea
gsp	Papua New Guinea
gss	Greece
gsw	Switzerland	Austria	Germany	Liechtenstein	France
gse	Ghana
gsg	Germany
gsm	Guatemala
gsl	Senegal
gso	Central African Republic
gsn	Papua New Guinea
hji	Indonesia (Papua)
eee	China
NOCODE_Samatu	China
kux	Australia
kaj	Nigeria
NOCODE_Hoxa	Colombia
ruk	Nigeria
cgk	Bhutan
rui	Tanzania
run	Burundi	Tanzania	Rwanda	Uganda
ruo	Croatia
cga	Papua New Guinea
ruc	Uganda
cgc	Philippines
ruf	Tanzania
rug	Solomon Islands
cgg	Uganda
rue	Ukraine	Slovakia	Belarus	Czech Republic	Estonia	Serbia	Croatia	Hungary
ruz	Nigeria
ruy	Nigeria
rus	Canada	Czech Republic	Lithuania	Mongolia	Slovakia	Norway	Turkmenistan	Uzbekistan	Israel	Belarus	China	Armenia	Germany	Kazakhstan	Ukraine	Kyrgyzstan	Georgia	Poland	Finland	Moldova	United States	Latvia	Croatia	Bulgaria	Romania	Estonia	Uruguay	Serbia	Azerbaijan	Russian Federation (Asia)	Mozambique	Greece	Tajikistan
rup	Romania	Albania	Serbia	Macedonia	Bosnia and Herzegovina	Greece	Bulgaria
ruq	Macedonia	Greece
rut	Russian Federation (Asia)	Azerbaijan
ruu	Malaysia (Peninsular)
bga	Nigeria
bgb	Indonesia (Papua)
bgc	India
bgd	India
bge	India
bgf	Congo	Cameroon
bgg	India
bgh	China
bgi	Philippines
idt	East Timor
bgk	China	Laos
idr	Sudan
ids	Nigeria
bgn	Tajikistan	Afghanistan	Iran	Turkmenistan	Pakistan
NOCODE_Bagua	Brazil
bgp	Pakistan	India
bgq	Pakistan	India
bgr	India	Bangladesh	Myanmar
bgs	Philippines
bgt	Solomon Islands
bgu	Nigeria	Cameroon
bgv	Indonesia (Papua)
bgw	India
bgx	Turkey (Asia)	Macedonia	Greece
bgy	Indonesia (Papua)
idd	Benin
ide	Nigeria
idb	Guatemala
idc	Nigeria
ida	Kenya
NOCODE_Kafr-Qasem-Sign	Israel
NOCODE_Quignam	Peru
pww	Thailand
pwr	India
aqp	United States
aqr	New Caledonia
aqz	Brazil
pwg	Papua New Guinea
aqg	Nigeria
pwb	Nigeria
aqc	Russian Federation (Asia)
pwa	Papua New Guinea
aqm	Indonesia (Papua)
pwo	Myanmar
aqn	Philippines
NOCODE_Mayoruna-Amazon	Brazil
pwi	United States
uta	Nigeria
ute	United States
NOCODE_Masacara	Brazil
utr	Nigeria
utp	Solomon Islands
utu	Papua New Guinea
bwb	Fiji
bzz	Nigeria	Cameroon
bwc	Democratic Republic of the Congo	Zambia
NOCODE_Sechuran	Peru
nab	Brazil
nac	Papua New Guinea
naa	Indonesia (Papua)
naf	Papua New Guinea
nag	India
nad	Australia
nae	Indonesia (Papua)
naj	Guinea	Guinea-Bissau
nak	Papua New Guinea
nan	Brunei	Singapore	Philippines	Malaysia (Peninsular)	Cambodia	United States	Indonesia (Papua)	China	Thailand	Taiwan
nao	Nepal
nal	Papua New Guinea
nam	Australia
nar	Nigeria
nas	Papua New Guinea
nap	Italy
naq	Namibia	Botswana	South Africa
nav	United States
naw	Ghana
nat	Nigeria
nau	Nauru
naz	Mexico
nax	Papua New Guinea
nay	Australia
esu	United States
est	Canada	Russian Federation (Asia)	Australia	Estonia	Finland	United Kingdom	Sweden	Latvia	United States
ess	Russian Federation (Asia)	United States
svl	China
svm	Italy
svk	Slovakia
bzk	Nicaragua
sve	Indonesia (Papua)
dva	Papua New Guinea
svc	Saint Vincent and the Grenadines
sva	Georgia
bwf	Papua New Guinea
svr	India
svs	Solomon Islands
cde	India
NOCODE_Pidgin-Madam	Lebanon
lkn	Vanuatu
lko	Kenya
NOCODE_Ewondo-Populaire	Cameroon
lkm	Australia
lkj	Malaysia (Peninsular)
lkh	Bhutan
lki	Iran
lkd	Brazil
lke	Uganda
lkb	Kenya
lkc	Viet Nam	China
lka	East Timor
lky	Sudan
lkt	Canada	United States
lkr	Sudan
lks	Kenya
NOCODE_West-Greenlandic-Eskimo-Pidgin	Denmark	Greenland
kce	Nigeria
kcd	Indonesia (Papua)
kcg	Nigeria
kcf	Nigeria
kca	Russian Federation (Asia)
kcc	Nigeria
kcb	Papua New Guinea
kcm	Sudan	Central African Republic
kcl	Papua New Guinea
kco	Papua New Guinea
kcn	United States	Kenya	Uganda
kci	Nigeria
kch	Nigeria
kck	Zimbabwe	Botswana
kcj	Senegal	Guinea-Bissau
kcu	Tanzania
kct	Papua New Guinea
kcw	Democratic Republic of the Congo
kcv	Democratic Republic of the Congo
kcq	Nigeria
kcp	Sudan
kcs	Nigeria
kcr	Sudan
kcy	Algeria
kcx	Ethiopia
kcz	Tanzania
syi	Gabon	Equatorial Guinea
bxx	Democratic Republic of the Congo
tmk	Nepal
bxq	Nigeria
bxp	Cameroon
bxs	Cameroon
bxr	Russian Federation (Asia)
bxu	China
bxw	Mali
bxv	Chad
bxi	Australia
bxh	Papua New Guinea
bxk	Kenya
bxj	Australia
bxm	Mongolia
bxl	Burkina Faso
bxo	Nigeria
bxn	Australia
bxa	Solomon Islands
bxc	Equatorial Guinea
bxb	Sudan
bxe	Ethiopia
bxd	China
bxg	Democratic Republic of the Congo
bxf	Papua New Guinea
NOCODE_Ladakhi-Sign	India
flh	Indonesia (Papua)
ycp	China	Laos
NOCODE_Karipuna	Brazil
ych	China
ycn	Colombia
ycl	China
NOCODE_Turku	Chad
ozm	Cameroon
NOCODE_Panzaleo	Brazil
fla	United States
vbb	Indonesia (Papua)
ula	Nigeria
bfe	Indonesia (Papua)
NOCODE_Arafundi-Enga-Pidgin	Papua New Guinea
wig	Australia
wif	Australia
wie	Australia
wic	United States
wib	Côte d'Ivoire	Burkina Faso
win	United States
wim	Australia
wil	Australia
wik	Australia
wij	Australia
wii	Papua New Guinea
wih	Australia
wiw	Australia
wiv	Papua New Guinea
wiu	Papua New Guinea
wit	United States
wir	Brazil
wiy	United States
asx	Papua New Guinea
NOCODE_Kustenau	Brazil
NOCODE_Sisiqa	Solomon Islands
NOCODE_Muzo	Colombia
xqt	Yemen
jns	India
NOCODE_Andoquero	Colombia
jna	India
jng	Australia
jnd	Pakistan
jnj	Ethiopia
jni	Nigeria
jnl	Nepal	India
NOCODE_Northeast-Bainounk	Nigeria
NOCODE_Bih	Viet Nam
glr	Liberia	Côte d'Ivoire
NOCODE_Khamnigan-Mongol	China
NOCODE_Komta	Nigeria
hlu	Turkey (Asia)
hlt	India	Myanmar
mas	Kenya	Tanzania
mar	Canada	Mauritius	Israel	United States	India
mau	Mexico
hle	China
hld	Viet Nam	Laos
hlb	India
hla	Papua New Guinea
snc	Papua New Guinea
mav	Brazil
max	Indonesia (Papua)
maz	Mexico
ecs	Ecuador
ecr	Greece
ecy	Cyprus
maa	Mexico
snu	Indonesia (Papua)
snr	Papua New Guinea
mad	Indonesia (Papua)	Singapore
mag	India
maf	Nigeria	Cameroon
snz	Papua New Guinea
rsl	Russian Federation (Asia)	Bulgaria
rsi	Solomon Islands
NOCODE_Tetserret	Niger
rsb	Serbia
cyb	Bolivia
cya	Mexico
cyo	Philippines
cym	Canada	United Kingdom	Argentina	United States
bej	Egypt	Eritrea	Sudan
bek	Papua New Guinea
beh	Burkina Faso	Benin
bei	Indonesia (Papua)
ben	Canada	United States	Saudi Arabia	Bangladesh	Singapore	United Arab Emirates	Nepal	India	United Kingdom	Malawi
beo	Papua New Guinea
bel	Canada	Ukraine	Kyrgyzstan	Belarus	Turkmenistan	Estonia	Tajikistan	Poland	Uzbekistan	Lithuania	Azerbaijan	Moldova	Russian Federation (Asia)	United States	Latvia	Kazakhstan
bem	Democratic Republic of the Congo	Zambia	Botswana	Malawi
beb	Cameroon
bec	Nigeria	Cameroon
bea	Canada
bef	Papua New Guinea
beg	Brunei	Malaysia (Peninsular)
bed	Indonesia (Papua)
bee	Nepal	India
bez	Tanzania
bex	Sudan
bey	Papua New Guinea
bes	Chad
bep	Indonesia (Papua)
beq	Congo
bev	Côte d'Ivoire
bew	Indonesia (Papua)
bet	Côte d'Ivoire
beu	Indonesia (Papua)
NOCODE_Gulunggulu	Australia
pyy	Myanmar
awy	Indonesia (Papua)
awx	Papua New Guinea
aww	Papua New Guinea
awv	Indonesia (Papua)
awu	Indonesia (Papua)
awt	Brazil
aws	Indonesia (Papua)
awr	Indonesia (Papua)
awo	Nigeria
awn	Ethiopia
awm	Papua New Guinea
awk	Australia
pym	Nigeria
awi	Papua New Guinea
awh	Indonesia (Papua)
awg	Australia
awe	Brazil
awc	Nigeria
awb	Papua New Guinea
awa	Nepal	India
urd	Canada	Afghanistan	Qatar	Bangladesh	Nepal	Norway	Malawi	Bahrain	Saudi Arabia	Zambia	Germany	Thailand	Pakistan	Oman	Mauritius	Guyana	United States	South Africa	United Arab Emirates	India	United Kingdom	Fiji	Botswana
ure	Bolivia
urf	Australia
urg	Papua New Guinea
ura	Peru
urb	Brazil
urc	Australia
url	India
urm	Papua New Guinea
urn	Indonesia (Papua)
uro	Papua New Guinea
urh	Nigeria
uri	Papua New Guinea
urk	Thailand
urt	Papua New Guinea
uru	Brazil
urv	Papua New Guinea
urw	Papua New Guinea
urp	Brazil
urr	Vanuatu
urx	Papua New Guinea
ury	Indonesia (Papua)
urz	Brazil
NOCODE_Payaya	United States
ngd	Central African Republic
nge	Cameroon
ngg	Central African Republic
nga	Democratic Republic of the Congo	Congo	Central African Republic
ngb	Democratic Republic of the Congo	Central African Republic
ngc	Democratic Republic of the Congo
ngl	Mozambique
ngm	Micronesia
ngn	Cameroon
ngo	Tanzania	Mozambique
ngh	South Africa
ngi	Nigeria
ngj	Cameroon
ngk	Australia
ngt	Laos
ngu	Mexico
ngv	Cameroon
ngw	Nigeria
ngp	Tanzania
ngq	Tanzania
ngr	Solomon Islands
ngs	Nigeria	Cameroon
ngx	Nigeria
ngy	Cameroon
ngz	Congo
tby	Indonesia (Papua)
tbx	Papua New Guinea
tbz	Togo	Benin
mgg	Cameroon
mgf	Indonesia (Papua)
mge	Chad
mgd	Sudan
mgk	Indonesia (Papua)
mgj	Nigeria
tbs	Papua New Guinea
tbr	Sudan
tbu	Mexico
tbt	Democratic Republic of the Congo
mgm	East Timor	Australia
mgl	Papua New Guinea
mgs	Tanzania
tbh	Australia
tbk	Philippines
mgp	Nepal	India	Bhutan
mgw	Tanzania
tbl	Philippines
tbo	Papua New Guinea
mgt	Papua New Guinea
tba	Brazil
mgz	Tanzania
tbc	Papua New Guinea
mgx	Papua New Guinea
tbe	Solomon Islands
tbd	Papua New Guinea
tbg	Papua New Guinea
tbf	Papua New Guinea
NOCODE_Guaicurian	Mexico
shq	Zambia
shr	Democratic Republic of the Congo
shs	Canada
sht	United States
shu	Niger	Cameroon	Central African Republic	Chad	Nigeria
shv	Oman
dpp	Malaysia (Peninsular)
shx	China
shy	Algeria
shz	Mali
sha	Nigeria
shb	Brazil	Venezuela
shc	Democratic Republic of the Congo
shd	Pakistan
she	Ethiopia
shg	Botswana
shh	United States
shi	Morocco	Algeria	France
shj	Sudan
shk	Sudan
shl	India
shm	Iran
shn	Thailand	China	Myanmar
sho	Nigeria
iby	Nigeria
lup	Congo	Gabon
luq	Cuba
lur	Indonesia (Papua)
lus	India	Bangladesh	Myanmar
lut	United States
luu	Nepal
luv	Oman
luw	Cameroon
luz	Iran
lua	Democratic Republic of the Congo
lub	Democratic Republic of the Congo
luc	Uganda
lud	Russian Federation (Asia)
lue	Zambia	Angola
luf	Papua New Guinea
lug	Uganda
lui	United States
luj	Democratic Republic of the Congo
NOCODE_Kiautschou-Pidgin-German	China
lul	Sudan
lum	Angola
lun	Democratic Republic of the Congo	Zambia	Angola
luo	Kenya	Tanzania
keo	Sudan	Democratic Republic of the Congo	Uganda
ken	Cameroon
kem	East Timor	Indonesia (Papua)
kel	Democratic Republic of the Congo
kek	El Salvador	Guatemala	Belize
kej	India
kei	Indonesia (Papua)
keh	Papua New Guinea
keg	Sudan
kef	Togo
kee	United States
ked	Tanzania
kec	Sudan
keb	Gabon
kea	Netherlands	Italy	Portugal	Luxembourg	France	United States	Senegal	Germany	Mozambique	Spain	Cape Verde Islands
jie	Nigeria
kez	Nigeria
key	India
kex	India
kew	Papua New Guinea
kev	India
keu	Togo
ket	Russian Federation (Asia)
kes	Nigeria
ker	Cameroon	Chad
keq	India
kep	India
NOCODE_Tangwang	China
NOCODE_Longjia	China
NOCODE_Koko-Dhawa	Australia
yay	Nigeria
yax	Zambia	Angola
yaz	Nigeria
yau	Venezuela
yat	Cameroon
yaw	Brazil
yav	Cameroon
yaq	United States	Mexico
yap	Micronesia
yas	Cameroon
yar	Venezuela
yam	Nigeria	Cameroon
yal	Guinea	Senegal	Sierra Leone	Mali
yao	Tanzania	Mozambique	Malawi	Zambia
yan	Nicaragua
yai	Tajikistan
yah	Tajikistan
yak	United States
yaj	Central African Republic
yae	Venezuela
yad	Peru	Colombia
yag	Chile
yaf	Democratic Republic of the Congo	Angola
yaa	Brazil	Bolivia	Peru
yac	Indonesia (Papua)
yab	Brazil	Colombia
oti	Brazil
NOCODE_Magati	Afghanistan
otl	Mexico
otm	Mexico
otn	Mexico
NOCODE_Afudu	Nigeria
jiq	China
otd	Indonesia (Papua)
ote	United States	Mexico
otx	Mexico
oty	India
otz	Mexico
otq	Mexico
otr	Sudan
ots	Mexico
ott	Mexico
otu	Brazil
otw	Canada	United States
jiy	China
NOCODE_Yimas-Karawari-Pidgin	Papua New Guinea
wka	Tanzania
wkb	India
wkd	Indonesia (Papua)
NOCODE_Ioi	Papua New Guinea
wku	India
wkw	Australia
NOCODE_Uainuma-Mariate	Brazil
sbw	Gabon
mzt	Malaysia (Peninsular)
mzu	Papua New Guinea
mzv	Central African Republic
mzw	Ghana	Côte d'Ivoire
mzp	Bolivia
mzq	Indonesia (Papua)
mzr	Brazil
mzs	China
mzx	Guyana
mzy	Mozambique
mzz	Papua New Guinea
mzd	Cameroon
mze	Papua New Guinea
mzg	Vatican State
mza	Mexico
mzb	Algeria
mzc	Madagascar
mzl	Mexico
mzm	Nigeria
mzn	Iran
mzo	Brazil
mzh	Argentina
mzi	Mexico
mzj	Guinea	Liberia
mzk	Nigeria
zyg	Viet Nam	China
zyb	China
zyn	Viet Nam	China
zyj	China
zyp	India	Myanmar
NOCODE_Guinea-Bissau-Sign	Guinea-Bissau
NOCODE_Western-Victoria	Australia
NOCODE_Wanyam	Brazil
NOCODE_Sorbung	India
xsr	Bhutan	Nepal	India	Korea	South	United States	China
xss	Russian Federation (Asia)
xsp	Papua New Guinea
xsq	Mozambique
xsu	Brazil	Venezuela
xsy	Taiwan
xsb	Philippines
xsa	Yemen
xsd	Turkey (Asia)
xse	Indonesia (Papua)
xsj	Tanzania
tgf	Bhutan
xsh	Nigeria
xsi	Papua New Guinea
xsn	Nigeria
xsl	Canada
xsm	Ghana	Burkina Faso
jls	Jamaica
jle	Sudan
NOCODE_Mayoruna-Tabatinga	Brazil
NOCODE_Julud	Sudan
swi	Viet Nam	China
swh	Canada	Libya	South Africa	Mayotte	United Arab Emirates	Tanzania	United States	Rwanda	Mozambique	Somalia	Uganda	Oman	Burundi	Kenya
duj	Australia
duk	Papua New Guinea
swm	Papua New Guinea
swl	Sweden
dun	Indonesia (Papua)
NOCODE_Taita	Kenya
duo	Philippines
dub	India
duc	Papua New Guinea
NOCODE_Tacunyape	Brazil
dud	Nigeria
swg	Germany
dug	Kenya
dux	Mali
duy	Philippines
NOCODE_Dima-Bottego	Ethiopia
swq	Cameroon
swp	Papua New Guinea
sws	Indonesia (Papua)
dma	Gabon
dmb	Mali
dus	Nepal
dme	Cameroon
dmg	Malaysia (Peninsular)
dmk	Pakistan
dml	Pakistan
dmm	Cameroon
dmo	Cameroon
dmr	Indonesia (Papua)
dms	Indonesia (Papua)
dmu	Indonesia (Papua)
dmv	Malaysia (Peninsular)
dmx	Mozambique
dmy	Indonesia (Papua)
duw	Indonesia (Papua)
NOCODE_Idabaez	Colombia
NOCODE_Wathawurrung	Australia
hna	Cameroon
bcm	Papua New Guinea
bcn	Nigeria
bco	Papua New Guinea
hne	India
hnd	Pakistan
bcj	Australia
bck	Australia
bcd	Indonesia (Papua)
bce	Cameroon
bcf	Papua New Guinea
hnj	Canada	Australia	Myanmar	Viet Nam	France	United States	French Guiana	Laos	China	Thailand
bca	China
bcb	Senegal
bcc	United Arab Emirates	Pakistan	Iran	Oman
hns	Trinidad and Tobago	Netherlands	Suriname	Guyana
hnu	Viet Nam	Laos
bcy	Nigeria
bcz	Gambia	Senegal
bct	Democratic Republic of the Congo
bcu	Papua New Guinea
bcv	Nigeria
bcw	Cameroon
bcp	Democratic Republic of the Congo
bcq	Ethiopia
bcr	Canada
bcs	Nigeria
aua	Solomon Islands
auc	Ecuador
aub	China
aue	Namibia	Botswana
aud	Solomon Islands
aug	Benin
aui	Papua New Guinea
auh	Democratic Republic of the Congo	Zambia
auk	Papua New Guinea
auj	Libya
aum	Nigeria
aul	Vanuatu
auo	Nigeria
aun	Papua New Guinea
auq	Indonesia (Papua)
aup	Papua New Guinea
aur	Papua New Guinea
auu	Indonesia (Papua)
aut	French Polynesia
auw	Indonesia (Papua)
auy	Papua New Guinea
aux	Brazil
auz	Uzbekistan
hch	Mexico
upi	Papua New Guinea
upv	Vanuatu
nen	New Caledonia
neo	Viet Nam
nem	New Caledonia
nej	Papua New Guinea
nek	New Caledonia
neh	Bhutan
nef	India
neg	Russian Federation (Asia)
ned	Nigeria
nee	New Caledonia
NOCODE_Guachipas	Argentina
nec	Indonesia (Papua)
nea	Indonesia (Papua)
nez	United States
nex	Papua New Guinea
ney	Côte d'Ivoire
nev	Laos
new	Nepal	India
net	Papua New Guinea
neu	Belgium
ner	Indonesia (Papua)
nes	India
neq	Mexico
mee	Papua New Guinea
med	Papua New Guinea
meg	New Caledonia
mef	Bangladesh
mea	Cameroon
mec	Australia
meb	Papua New Guinea
mem	Australia
mel	Brunei	Malaysia (Peninsular)
meo	Thailand	Malaysia (Peninsular)
men	Liberia	Sierra Leone
mei	Sudan
meh	Mexico
mek	Papua New Guinea
mej	Indonesia (Papua)
meu	Papua New Guinea
met	Papua New Guinea
mew	Nigeria
mev	Guinea	Liberia
meq	Cameroon
mep	Australia
mes	Chad
mer	Kenya
mey	Mauritania	Western Sahara	Libya	Morocco	Senegal	Algeria	Mali	Niger
mez	United States
dry	Nepal
NOCODE_Japhug	China
NOCODE_Umiida-Unggarangu	Australia
drq	Nepal
sjs	Morocco
drs	Ethiopia
drr	Solomon Islands
dru	Taiwan
sjw	United States
drw	Afghanistan
sju	Sweden
dri	Nigeria
drh	Mongolia
sjo	China
dro	Malaysia (Peninsular)
drn	Indonesia (Papua)
sjb	Indonesia (Papua)
drc	Portugal
sja	Panama	Ecuador	Colombia
dre	Nepal
drd	Nepal	India
sjd	Russian Federation (Asia)
sje	Sweden	Norway
esk	United States
lww	Vanuatu
lwt	Indonesia (Papua)
lwh	Viet Nam
lwo	Sudan
lwl	Thailand
lwm	China
lwa	Democratic Republic of the Congo
lwg	Kenya
lwe	Indonesia (Papua)
kgq	Indonesia (Papua)
kgp	Brazil
kgs	Australia
kgr	Indonesia (Papua)
kgu	Papua New Guinea
kgt	Nigeria
kgw	Indonesia (Papua)
kgv	Indonesia (Papua)
kgy	Nepal	China
kgx	Indonesia (Papua)
kga	Côte d'Ivoire
kgc	Laos
kgb	Indonesia (Papua)
kge	Indonesia (Papua)
kgd	Laos
kgg	Nepal
kgf	Papua New Guinea
kgi	Malaysia (Peninsular)
kgh	Philippines
kgk	Brazil	Argentina
kgj	Nepal
kgm	Brazil
kgl	Australia
kgo	Sudan
kgn	Iran
NOCODE_Ware	Tanzania
mwh	Papua New Guinea
xhe	Pakistan
xhd	Yemen
xho	Lesotho	Botswana	South Africa
mwn	Tanzania	Zambia
xhv	Viet Nam	Laos
xhu	Turkey (Asia)
xht	Iraq
ygm	Papua New Guinea
ygl	Papua New Guinea
NOCODE_Konomihu	United States
ygw	Papua New Guinea
NOCODE_Northern-Hmong	China
ygr	Papua New Guinea
ygp	China
wur	Australia
wuv	Papua New Guinea
wuu	United States	China
wut	Papua New Guinea
wuy	Indonesia (Papua)
wux	Australia
wub	Australia
NOCODE_Yanacona	Colombia
NOCODE_Bigambal	Australia
NOCODE_Nam	Viet Nam
wud	Togo
wuh	China
wun	Tanzania
wum	Congo	Gabon
wul	Indonesia (Papua)
mxz	Indonesia (Papua)
mxx	Côte d'Ivoire
mxy	Mexico
mxv	Mexico
mxw	Papua New Guinea
mxt	Mexico
mxu	Cameroon
mxr	Malaysia (Peninsular)
mxs	Mexico
NOCODE_Barranbinya	Australia
mxq	Mexico
mxn	Indonesia (Papua)
mxo	Zambia
mxl	Togo	Benin
mxm	Papua New Guinea
mxj	India
mxk	Papua New Guinea
mxh	Democratic Republic of the Congo	Uganda
mxi	Spain
mxf	Cameroon	Chad
mxg	Angola
mxd	Indonesia (Papua)
mxe	Vanuatu
mxb	Mexico
mxc	Zimbabwe	Mozambique
mxa	Mexico
zwa	Ethiopia
dyb	Australia
NOCODE_Bonin-English-Pidgin	Japan
NOCODE_Erie	United States
xut	Australia
xuu	Namibia	Zambia	Angola	Botswana	South Africa
xur	Iraq
NOCODE_Bafoto	Democratic Republic of the Congo
isu	Cameroon
ist	Croatia
isi	Nigeria
ish	Nigeria
iso	Nigeria
isn	Tanzania
xub	India
isl	Canada	Iceland	United States
isc	Peru
xum	Italy
isa	Papua New Guinea
xuo	Cameroon	Chad
isg	Ireland
xuj	India
isd	Philippines
NOCODE_Marawan	Brazil
fmp	Cameroon
jje	South Korea
gyg	Central African Republic
gyf	Australia
gye	Nigeria
gyd	Australia
gyb	Papua New Guinea
gya	Nigeria	Congo	Cameroon	Central African Republic
gyn	United States	Suriname	Guyana
gym	Panama	Costa Rica
gyl	Ethiopia
gyi	Cameroon	Equatorial Guinea
gyr	Bolivia
gyy	Australia
NOCODE_Pidgin-Fijian	Fiji
NOCODE_Taut-Batu	Philippines
tyl	Viet Nam
tyn	Indonesia (Papua)
tyh	Viet Nam	Laos
tyi	Congo	Gabon
tyj	Viet Nam
tye	Nigeria	Benin
tya	Papua New Guinea
tyx	Congo
tyz	United States	Viet Nam	France
tyt	Viet Nam
tyu	Botswana
tyv	Russian Federation (Asia)	China	Mongolia
typ	Australia
tyr	United States	Thailand	Viet Nam	Laos
tys	Viet Nam
dok	Indonesia (Papua)
doh	Nigeria
don	Papua New Guinea
doo	Democratic Republic of the Congo
dol	Papua New Guinea
dob	Papua New Guinea
doc	Viet Nam	China
NOCODE_Elinga	Democratic Republic of the Congo
doa	Papua New Guinea
dof	Papua New Guinea
doe	Tanzania
doz	Ethiopia
dox	Ethiopia
doy	Ghana
NOCODE_Jova	Mexico
dor	Solomon Islands
dos	Burkina Faso
dop	Togo	Benin
doq	Dominican Republic
dov	Zimbabwe
dow	Cameroon
dot	Nigeria
NOCODE_Dzubukua	Brazil
kul	Nigeria
kuj	Kenya	Tanzania
bav	Cameroon
baw	Cameroon
bau	Nigeria
bar	Italy	Austria	Germany	Czech Republic
bas	Cameroon
bap	Nepal	Bhutan
baz	Cameroon
bax	Cameroon
bay	Indonesia (Papua)
baf	Cameroon
bag	Cameroon
bae	Venezuela
bab	Guinea-Bissau
bac	Indonesia (Papua)
baa	Solomon Islands
ban	Indonesia (Papua)
bao	Brazil	Colombia
bam	Mauritania	Gambia	Senegal	Guinea	Mali	Côte d'Ivoire	Burkina Faso
baj	Indonesia (Papua)
bak	Ukraine	Uzbekistan	Kyrgyzstan	Turkmenistan	Kazakhstan	Russian Federation (Asia)	Tajikistan
bah	Bahamas	United States
NOCODE_Kuyubi	Brazil
omc	Peru
omb	Vanuatu
oma	United States
omg	Brazil	Peru
ome	Colombia
omk	Russian Federation (Asia)
omi	Democratic Republic of the Congo
omo	Papua New Guinea
omn	Greece
oml	Democratic Republic of the Congo
omr	India
omw	Papua New Guinea
omu	Peru
omt	Kenya
omx	Thailand
unr	Nepal	India	Bangladesh
unu	Papua New Guinea
unx	India
unz	Indonesia (Papua)
fng	Democratic Republic of the Congo	Zambia	Zimbabwe	Namibia	South Africa
una	Papua New Guinea
une	Nigeria
ung	Australia
unk	Brazil
unm	United States
fni	Chad
NOCODE_Yurumangui	Colombia
mco	Mexico
mcn	Cameroon	Chad
mcm	Malaysia (Peninsular)
mcl	Colombia
mck	Zambia	Angola
mcj	Nigeria
mci	Papua New Guinea
gli	Solomon Islands
NOCODE_Ndyuka-Wayana-Pidgin	Suriname
mcf	Brazil	Peru
mce	Mexico
mcd	Brazil	Peru
mcc	Papua New Guinea
aky	India
mca	Paraguay
akx	India
mcz	Papua New Guinea
mcy	Papua New Guinea
mcx	Congo	Cameroon	Central African Republic
mcw	Chad
mcv	Papua New Guinea
NOCODE_Pamunkey	United States
mct	Cameroon
mcs	Cameroon	Chad
mcr	Papua New Guinea
mcq	Papua New Guinea
mcp	Cameroon
slx	Democratic Republic of the Congo
sly	Indonesia (Papua)
slz	Indonesia (Papua)
slt	Viet Nam	Laos
slu	Indonesia (Papua)
slv	Canada	Australia	Italy	Serbia	United States	Slovenia	Austria	Croatia	Hungary	Argentina
slw	Papua New Guinea
slp	Indonesia (Papua)
slq	Iran
slr	China
sls	Singapore
sll	Papua New Guinea
slm	Philippines
sln	United States
slh	United States
sli	Poland	Czech Republic
slj	Brazil
slk	Canada	Ukraine	Romania	Czech Republic	Serbia	Poland	Montenegro	United States	Austria	Croatia	Hungary	Slovakia
sld	Burkina Faso
sle	India
slf	Switzerland
slg	Indonesia (Papua)	Malaysia (Peninsular)
slc	Venezuela	Colombia
glc	Chad
akw	Congo
NOCODE_Pidgin-Gulf-Arabic	Saudi Arabia
glg	Portugal	Spain
gly	Sudan
kiz	Tanzania
kiy	Indonesia (Papua)
kix	India
kis	Papua New Guinea
kir	Turkey (Asia)	Afghanistan	Kyrgyzstan	Tajikistan	Uzbekistan	Russian Federation (Asia)	United States	China	Kazakhstan
kiq	Indonesia (Papua)
kip	Nepal
kiw	Papua New Guinea
kiv	Tanzania
kiu	Turkey (Asia)	Netherlands	Denmark	Sweden	France	United Kingdom	Austria	Germany	Switzerland
kit	Papua New Guinea
kik	Kenya
kij	Papua New Guinea
kii	United States
kih	Papua New Guinea
kio	United States
kin	Burundi	Democratic Republic of the Congo	Rwanda	Uganda
kim	Russian Federation (Asia)
kil	Nigeria
kic	United States	Mexico
kib	Sudan
kia	Chad
NOCODE_Mongoba-Kazibati	Democratic Republic of the Congo
kig	Indonesia (Papua)
kif	Nepal
kie	Chad
kid	Cameroon
NOCODE_San-Francisco-Solano	United States
glu	Chad
ake	Brazil	Venezuela	Guyana
akd	Nigeria
yei	Cameroon
yej	United States	Israel
yel	Democratic Republic of the Congo
yen	Nigeria
yea	India
yec	Switzerland	Austria	Netherlands	Germany	France
yee	Papua New Guinea
yey	Namibia	Botswana
yes	Nigeria
yer	Nigeria
yeu	India
yet	Indonesia (Papua)	Papua New Guinea
yev	Papua New Guinea
opt	Mexico
NOCODE_Seb-Seliyer	Iran
NOCODE_Mayo	Brazil
opy	Brazil
opa	Nigeria
opm	Papua New Guinea
opo	Papua New Guinea
NOCODE_Jirajaran	Venezuela
opk	Indonesia (Papua)
whu	Indonesia (Papua)
eli	Sudan
NOCODE_Tabancale	Peru
www	Cameroon
wwr	Australia
NOCODE_Nitita	Vanuatu
wwa	Benin
wwb	Australia
wwo	Vanuatu
NOCODE_Chono	Chile
NOCODE_Paravilhana	Brazil
NOCODE_Kimda	Paraguay
zuy	Cameroon
zua	Nigeria
NOCODE_Mimi-Gaudefroy	Chad
zuh	Papua New Guinea
zun	United States
zul	South Africa	Malawi	Lesotho	Mozambique	Swaziland	Botswana
zum	Oman
NOCODE_Pidgin-Hindustani	Fiji
NOCODE_Nabit	Ghana
NOCODE_Avok	Vanuatu
NOCODE_Pericu	Mexico
NOCODE_NE-Tasmanian-Dialect-Chain	Australia
iqu	Peru
xwr	Indonesia (Papua)
xwl	Togo	Benin
xwg	Ethiopia
xwe	Benin
xwc	United States
xwa	Brazil
NOCODE_West-Nyala	Kenya
NOCODE_Okwanuchu	United States
NOCODE_Mahigi	Papua New Guinea
fse	Finland
fsl	Togo	France
fss	Finland
NOCODE_Island-Takic	United States
tnu	Laos
NOCODE_Giya	Australia
erw	Indonesia (Papua)
dil	Sudan
dim	Ethiopia
dio	Nigeria
dih	United States	Mexico
dii	Cameroon
dij	Indonesia (Papua)
dik	Sudan
jhi	Malaysia (Peninsular)
dif	Australia
dig	Kenya	Tanzania
dia	Papua New Guinea
dib	Sudan
dic	Côte d'Ivoire
jhs	Nepal
dix	Vanuatu
diy	Indonesia (Papua)
diz	Democratic Republic of the Congo
dit	Australia
diu	Namibia	Angola	Botswana
div	Maldives	India
diw	Sudan
dip	Sudan
diq	Turkey (Asia)	Germany
dir	Nigeria
dis	India
ruh	India
rub	Uganda
erg	Vanuatu
box	Burkina Faso
boy	Central African Republic
hbo	Israel
tnn	Vanuatu
bop	Papua New Guinea
tni	Indonesia (Papua)
bor	Brazil
bos	Montenegro	Serbia	Croatia	Bosnia and Herzegovina
hba	Democratic Republic of the Congo
bou	Tanzania
bov	Ghana
tnh	Papua New Guinea
boh	Democratic Republic of the Congo
boi	United States
boj	Papua New Guinea
bok	Congo
bol	Nigeria
bom	Nigeria
NOCODE_Lenca-Honduras	Honduras
boo	Mali
hbu	East Timor
boa	Brazil	Peru	Colombia
bob	Kenya	Somalia
bod	Bhutan	Nepal	India	United States	China	Switzerland	Taiwan	Norway
boe	Cameroon
bof	Burkina Faso
bog	Mali
ayl	Egypt	Niger	Libya
ayo	Paraguay	Bolivia
ayn	Yemen
ayi	Nigeria
ayh	Eritrea	Yemen	Kenya
ayk	Nigeria
aye	Nigeria
ayd	Australia
ayg	Togo
aya	Papua New Guinea
ayc	Peru
ayb	Benin
ayy	Philippines
ayx	China
ayz	Indonesia (Papua)
ayu	Nigeria
ayt	Philippines
ayq	Papua New Guinea
ayp	Turkey (Asia)	Syria	Iraq	Jordan
ays	Philippines
ayr	Argentina	Bolivia	Peru	Chile
ood	United States	Mexico
oog	Laos
NOCODE_Cueva	Panama
oon	India
oos	Ukraine
oor	South Africa
fly	South Africa
flr	Democratic Republic of the Congo
ulw	Nicaragua
ulu	Indonesia (Papua)
fli	Nigeria
ulk	Papua New Guinea
uli	Micronesia
uln	Australia	Papua New Guinea
fll	Cameroon
ull	India
fln	Australia
ulb	Nigeria
ulc	Russian Federation (Asia)
NOCODE_Baenan	Brazil
ulf	Indonesia (Papua)
bgj	Cameroon
idu	Nigeria
bgl	Laos
bgm	Guinea
NOCODE_Culli	Peru
bgo	Guinea
nyx	Australia
nyy	Tanzania	Malawi
nyr	Malawi
nys	Australia
nyp	Uganda
nyq	Iran
nyv	Australia
nyw	Thailand
nyt	Australia
nyu	Mozambique
nyj	Democratic Republic of the Congo
nyk	Angola
nyh	Australia
nyi	Sudan
nyn	Uganda
nyo	Uganda
nyl	Thailand
nym	Tanzania
nyb	Ghana
nyc	Democratic Republic of the Congo
nya	Zambia	Malawi	Zimbabwe	Mozambique	Swaziland	Botswana
nyf	Kenya
nyg	Democratic Republic of the Congo
nyd	Kenya
nye	Angola
snf	Senegal
sng	Democratic Republic of the Congo
snd	Canada	Pakistan	Singapore	Oman	Philippines	India	United Kingdom	United States
sne	Malaysia (Peninsular)
snb	Malaysia (Peninsular)
mat	Mexico
maw	Ghana	Togo
sna	Zambia	South Africa	Zimbabwe	Botswana	Malawi
snn	Ecuador	Colombia
sno	United States
snl	Philippines
snm	Uganda
snj	Central African Republic
snk	Mauritania	Gambia	Senegal	Guinea	Guinea-Bissau	Mali	Côte d'Ivoire
snh	Bolivia
sni	Peru
snv	Indonesia (Papua)	Malaysia (Peninsular)
snw	Ghana
mab	Mexico
mae	Nigeria
sns	Vanuatu
snp	Papua New Guinea
snq	Gabon
mai	Nepal	India
mah	United States	Nauru	Marshall Islands
mak	Indonesia (Papua)
maj	Mexico
mam	Guatemala	Mexico
mal	Bahrain	Canada	Israel	Singapore	United Arab Emirates	India	Qatar	Malaysia (Peninsular)	United Kingdom	United States	Fiji
snx	Papua New Guinea
sny	Papua New Guinea
zna	Chad
zng	Thailand	China	Viet Nam
zne	Sudan	Democratic Republic of the Congo	Central African Republic
znk	Australia
zns	Nigeria
lsg	France
lsd	Israel
lse	Democratic Republic of the Congo
lsa	Iran
lso	Laos
lsl	Latvia
lsm	Kenya	Uganda
NOCODE_Ambermo	Indonesia (Papua)
lsh	India
lsi	China	Myanmar
lst	Trinidad and Tobago
lsr	Papua New Guinea
lss	Pakistan
lsp	Panama
lsy	Mauritius
qhr	Italy
kky	Australia
kkx	Indonesia (Papua)
kkz	Canada
kku	Nigeria
kkt	Nepal
kkw	Congo
kkv	Indonesia (Papua)
kkq	Democratic Republic of the Congo
kkp	Australia
kks	Nigeria
kkr	Nigeria
kkm	Nigeria
kkl	Indonesia (Papua)
kko	Sudan
kkn	China
kki	Tanzania
kkh	Thailand	Myanmar
kkk	Solomon Islands
kkj	Congo	Cameroon	Central African Republic
kke	Guinea
kkd	Nigeria
kkg	Philippines
kkf	India
kka	Nigeria
kkc	Papua New Guinea
kkb	Indonesia (Papua)
xlo	United States
xle	Greece
xld	Turkey (Asia)
xlc	Turkey (Asia)
xla	Papua New Guinea
xly	Italy
xlu	Turkey (Asia)
xls	Spain
xlp	Italy
NOCODE_Jabal-Razih	Yemen
NOCODE_Khuai	South Africa
xpk	Brazil
orz	Indonesia (Papua)
orx	Nigeria
ory	India
orv	Russia
orw	Brazil
ort	United States	India
oru	Afghanistan	Pakistan
orr	Nigeria
ors	Malaysia (Peninsular)	Singapore
orn	Malaysia (Peninsular)
oro	Papua New Guinea
NOCODE_Cashinawa-Tarauaca-River	Brazil
orh	China
org	Nigeria
ore	Peru
orc	Kenya
ora	Solomon Islands
ixl	Guatemala
NOCODE_Tushan	Iran
NOCODE_Allentiac	Argentina
zsu	Papua New Guinea
zsr	Mexico
NOCODE_Awngtim-Ntrangit	Australia
zsa	Papua New Guinea
zsl	Zambia
zsm	Brunei	Malaysia (Peninsular)	Singapore
NOCODE_Bunganditj	Australia
NOCODE_Mure	Bolivia
iwo	Indonesia (Papua)
iwm	Papua New Guinea
iwk	Philippines
iws	Papua New Guinea
aqd	Mali
NOCODE_Kitemoka	Bolivia
pwn	Taiwan
NOCODE_Concho	Mexico
pwm	Philippines	Malaysia (Peninsular)
ges	Indonesia (Papua)
geq	Central African Republic
gew	Nigeria
gev	Gabon
gez	Eritrea	Ethiopia
gey	Democratic Republic of the Congo
gex	Somalia
gec	Liberia
geb	Papua New Guinea
gea	Nigeria
geg	Nigeria
ged	Nigeria
gek	Nigeria
gej	Togo	Benin
gei	Indonesia (Papua)
geh	Canada	United States
gel	Nigeria
fqs	Papua New Guinea
tux	Brazil
tuy	Kenya
tuz	Côte d'Ivoire	Burkina Faso
clm	United States
tuq	Chad	Niger	Nigeria	Libya
tur	Canada	France	Uzbekistan	Netherlands	Turkey (Asia)	Russian Federation (Asia)	Israel	Australia	Iran	El Salvador	Germany	Bosnia and Herzegovina	Belgium	Iraq	Kazakhstan	Ukraine	Kyrgyzstan	Georgia	Denmark	Finland	Macedonia	United States	Tajikistan	Sweden	Switzerland	Bulgaria	Romania	Honduras	Egypt	United Arab Emirates	Serbia	Azerbaijan	United Kingdom	Austria	Greece	Cyprus
tus	Canada	United States
tuu	United States
tuv	Ethiopia	Kenya
NOCODE_South-Arabian-Unknown-k	Saudi Arabia
tui	Cameroon	Chad
tuj	Indonesia (Papua)
tuk	Turkey (Asia)	Afghanistan	Kyrgyzstan	Iran	Turkmenistan	Pakistan	Tajikistan	Uzbekistan	Russian Federation (Asia)	United States	Germany	Syria	Iraq	Kazakhstan
tul	Nigeria
tum	Zambia	Malawi
tun	United States
tuo	Brazil	Colombia
tua	Papua New Guinea
tub	United States
tuc	Papua New Guinea
tud	Brazil
tue	Brazil	Colombia
tuf	Venezuela	Colombia
tug	Chad
tuh	Papua New Guinea
dkr	Malaysia (Peninsular)
dks	Canada	Sudan
dkx	Cameroon
imi	Papua New Guinea
dka	Bhutan
dkl	Mali
dkk	Indonesia (Papua)
cla	Nigeria
aic	Papua New Guinea
NOCODE_Panche	Colombia
imn	Papua New Guinea
cqd	China
cqu	Chile
bmb	Democratic Republic of the Congo	Tanzania
bmc	Papua New Guinea
bma	Nigeria
bmf	Sierra Leone
bmg	Democratic Republic of the Congo
bmd	Guinea
bme	Central African Republic
bmj	Nepal
bmk	Papua New Guinea
bmh	Papua New Guinea
bmi	Nigeria	Chad
bmn	Papua New Guinea
bmo	Cameroon
bml	Democratic Republic of the Congo
bmm	Madagascar
bmr	Colombia
bms	Niger
bmp	Papua New Guinea
bmq	Burkina Faso	Mali
bmv	Cameroon
bmw	Congo	Cameroon
bmt	China
bmu	Papua New Guinea
bmz	Papua New Guinea
bmx	Papua New Guinea
bmy	Democratic Republic of the Congo
hds	Honduras
hdy	Ethiopia
NOCODE_Envuelto	Colombia
hdn	Canada	United States
NOCODE_Pauwi	Indonesia (Papua)
pap	Netherlands	U.S. Virgin Islands	United States	Aruba	Puerto Rico	Netherlands Antilles
paq	Uzbekistan	Afghanistan	Tajikistan
par	United States
pas	Indonesia (Papua)
pat	Papua New Guinea
pau	United States	Guam	Palau
pav	Brazil
paw	United States
pax	Brazil
pay	Honduras
paz	Brazil
NOCODE_Kuwaiti-Sign	Kuwait
pab	Brazil
pac	Viet Nam	Laos
pad	Brazil
pae	Democratic Republic of the Congo
paf	Brazil
pag	United States	Philippines
pah	Brazil
pai	Nigeria
pak	Brazil
pal	India
pam	United States	Philippines
pan	Canada	Mauritius	Bangladesh	Libya	Singapore	United Arab Emirates	India	Malaysia (Peninsular)	United Kingdom	United States	Kenya	Fiji
pao	United States
oin	Papua New Guinea
kju	United States
oia	Indonesia (Papua)
NOCODE_Pidgin-Kaurna	Australia
uji	Nigeria
NOCODE_Mbiywom	Australia
moz	Chad
moy	Ethiopia
mox	Papua New Guinea
mos	Ghana	Togo	Senegal	Mali	Côte d'Ivoire	Burkina Faso	Benin
mor	Sudan
moq	Indonesia (Papua)
mop	Guatemala	Belize
mow	Congo
mov	United States
mou	Chad
mot	Venezuela	Colombia
mok	Indonesia (Papua)
moj	Democratic Republic of the Congo	Congo	Central African Republic
moi	Nigeria
moh	Canada	United States
moo	Viet Nam
mom	Nicaragua
moc	Argentina
moa	Côte d'Ivoire
mog	Indonesia (Papua)
mof	United States
moe	Canada
mod	United States
zlm	Canada	Myanmar	Singapore	United Arab Emirates	Malaysia (Peninsular)	United States	Indonesia (Papua)
zln	China
zlj	China
zlq	China
NOCODE_Russenorsk	Norway
NOCODE_Guwa	Australia
kmg	Papua New Guinea
kmf	Papua New Guinea
kme	Cameroon
kmd	Philippines
kmc	China
kmb	Angola
kma	Ghana
kmo	Papua New Guinea
kmn	Papua New Guinea
kmm	India
kml	Philippines
kmk	Philippines
kmj	India
kmi	Nigeria
kmh	Papua New Guinea
kmw	Democratic Republic of the Congo
kmv	Brazil
kmu	Papua New Guinea
kmt	Indonesia (Papua)
kms	Papua New Guinea
kmr	Canada	Afghanistan	Italy	Turkmenistan	Kuwait	France	Netherlands	Norway	Bahrain	Russian Federation (Asia)	Australia	Iran	Jordan	Armenia	Belgium	Germany	Iraq	Kazakhstan	Turkey (Asia)	Kyrgyzstan	Georgia	Denmark	Finland	United States	Sweden	Switzerland	Syria	Lebanon	Azerbaijan	United Kingdom	Austria	Greece
kmq	Ethiopia
kmp	Cameroon
kmz	Iran
kmy	Nigeria	Cameroon
kmx	Papua New Guinea
zpx	Mexico
xns	India
xnr	India
xna	Iraq
xnb	Taiwan
xnh	China
xnn	Philippines
yyu	Papua New Guinea
yyr	Australia
zpu	United States	Mexico
NOCODE_Hezhou	China
yyz	China
NOCODE_Kantarure	Brazil
NOCODE_Yilan-Creole-Japanese	Taiwan
NOCODE_Georgian-Sign	Georgia
svb	Papua New Guinea
NOCODE_Shanjo	Zambia
NOCODE_Siti	C\^ote d'Ivoire
ajz	India
NOCODE_Kabikabi	Australia
goe	Bhutan
god	Côte d'Ivoire
zqe	China
NOCODE_Hachijo	Japan
goa	Côte d'Ivoire
ajw	Nigeria
ium	Myanmar	Denmark	Viet Nam	France	United States	Switzerland	China	Laos	Belgium	Thailand	New Zealand
aja	Sudan
NOCODE_Cariay	Brazil
NOCODE_Sadu	China
wsa	Indonesia (Papua)
hya	Nigeria	Cameroon
hye	Canada	Turkmenistan	Lebanon	France	Palestinian West Bank and Gaza	Turkey (Asia)	Uzbekistan	Israel	Iran	Jordan	Armenia	Iraq	Kazakhstan	Ukraine	Kyrgyzstan	Georgia	United States	Syria	Bulgaria	Romania	Honduras	Estonia	Egypt	Tajikistan	India	Azerbaijan	Russian Federation (Asia)	Greece	Hungary	Cyprus
wsi	Vanuatu
wsk	Papua New Guinea
wss	Ghana
wsr	Papua New Guinea
wsu	Brazil
wsv	Afghanistan
NOCODE_Tep	Nigeria
gor	Indonesia (Papua)
aba	Côte d'Ivoire
abb	Cameroon
abc	Philippines
abd	Philippines
abe	Canada
abf	Malaysia (Peninsular)
abg	Papua New Guinea
abh	Uzbekistan	Afghanistan	Tajikistan
abi	Côte d'Ivoire
abj	India
abk	Russian Federation (Asia)	Turkey (Asia)	Georgia	Ukraine
abl	Indonesia (Papua)
abm	Nigeria
abn	Nigeria
abo	Nigeria
abp	Philippines
abq	Russian Federation (Asia)	Turkey (Asia)	Germany
abr	Ghana	Côte d'Ivoire
abs	United States	Indonesia (Papua)	Netherlands
abt	Papua New Guinea
abu	Côte d'Ivoire
abv	Bahrain	Oman
abw	Papua New Guinea
abx	Philippines
aby	Papua New Guinea
abz	Indonesia (Papua)
NOCODE_Kassite	Iraq
ggu	Côte d'Ivoire
ggt	Papua New Guinea
ggw	Papua New Guinea
ggr	Australia
lkl	Papua New Guinea
gge	Australia
ggd	Australia
ggg	Pakistan
akv	Russian Federation (Asia)
gga	Solomon Islands
ggb	Liberia
ggm	Australia
ggl	Papua New Guinea
ggo	India
ggn	Nepal
ggk	Australia
NOCODE_Mardin-Sign	Turkey (Asia)
fwe	Namibia
fwa	New Caledonia
NOCODE_Central-Ju	Namibia
NOCODE_Magiana	Bolivia
NOCODE_Morike	Peru
sbh	Papua New Guinea
eya	United States
twc	Nigeria
twa	United States
twf	United States
twg	Indonesia (Papua)
twd	Netherlands
twe	Indonesia (Papua)
twh	Viet Nam	Laos	China	France
twn	Cameroon
two	Botswana
eyo	Kenya
twm	India	China
twr	Mexico
NOCODE_Pitaguary	Brazil
twp	Papua New Guinea
twq	Niger
tww	Papua New Guinea
twt	Brazil
twu	Indonesia (Papua)
twx	Mozambique
twy	Indonesia (Papua)
dez	Democratic Republic of the Congo
dep	United States
deq	Central African Republic
jdg	Pakistan	Iran
des	Brazil	Colombia
jda	India
deu	Brazil	Canada	Italy	Czech Republic	Luxembourg	France	Namibia	Argentina	Bolivia	Slovakia	Ecuador	Uzbekistan	Israel	Australia	Slovenia	Germany	Bosnia and Herzegovina	Chile	Puerto Rico	Belgium	Kazakhstan	Poland	Ukraine	Kyrgyzstan	Denmark	Philippines	Finland	Moldova	United States	Liechtenstein	Croatia	Switzerland	Romania	Estonia	Uruguay	United Arab Emirates	South Africa	Russian Federation (Asia)	Austria	Mozambique	Paraguay	Hungary	Tajikistan
dev	Papua New Guinea
deh	Pakistan
dei	Indonesia (Papua)
dek	Cameroon
dem	Indonesia (Papua)
jdt	Russian Federation (Asia)	Israel	Azerbaijan
dec	Sudan
ded	Papua New Guinea
dee	Liberia
def	Iran
deg	Nigeria
NOCODE_Jesuit-Maynas	Peru
NOCODE_Bularnu	Australia
ryn	Japan
csl	Malaysia (Peninsular)	Taiwan	China
cso	Mexico
csn	Colombia
csi	United States
csh	Bangladesh	Myanmar
csk	Gambia	Senegal
cse	Czech Republic
csd	Thailand
csg	Chile
csf	Cuba
csa	Mexico
csc	Spain
csb	Canada	Poland
csy	Myanmar
csz	United States
cst	United States
csw	Canada
ryu	Japan
csq	Croatia
rys	Japan
css	United States
csr	Costa Rica
bkd	Philippines
bkf	Democratic Republic of the Congo
bkg	Democratic Republic of the Congo	Central African Republic
bka	Nigeria
bkb	Philippines
bkc	Gabon	Cameroon
bkl	Indonesia (Papua)
bkm	Cameroon
bkn	Indonesia (Papua)	Malaysia (Peninsular)
bko	Cameroon
bkh	Cameroon
bki	Vanuatu
bkj	Central African Republic
bkk	India
bkt	Democratic Republic of the Congo
bku	Philippines
bkv	Nigeria
bkw	Gabon	Congo	Cameroon
bkp	Democratic Republic of the Congo
bkq	Brazil
bkr	Indonesia (Papua)
bks	Philippines
bkx	East Timor
bky	Nigeria	Cameroon
bkz	Indonesia (Papua)
NOCODE_Castelmezzano	Italy
NOCODE_Francais-Tirailleur	Senegal
NOCODE_Queensland-Kanaka-English	Australia
pcr	China
pcp	Bolivia
pcw	Nigeria
pcj	India
pck	India	Myanmar
pch	India
pci	India
pcn	Nigeria
pcl	India
pcm	Nigeria
pcb	Cambodia
pcc	United States	Viet Nam	China	France
pca	Mexico
pcf	India
pcg	India
pcd	Belgium	France
pce	Thailand	China	Myanmar
oks	Nigeria
okr	Nigeria
oku	Cameroon
uha	Nigeria
uhn	Indonesia (Papua)
okx	Nigeria
oka	Canada	United States
okb	Nigeria
oke	Nigeria
okd	Nigeria
oki	Kenya	Tanzania
okh	Iran
okk	Papua New Guinea
okj	India
okl	United Kingdom
okn	Japan
sbr	Indonesia (Papua)	Malaysia (Peninsular)
sbs	Zambia	Namibia	Botswana
sbp	Tanzania
sbq	Papua New Guinea
mmy	Chad
mmx	Papua New Guinea
sbt	Indonesia (Papua)
sbu	India
sbz	Central African Republic
mmt	Papua New Guinea
mmw	Vanuatu
mmv	Brazil
mmq	Papua New Guinea
mmp	Papua New Guinea
mms	Guatemala
mmr	China
sbb	Solomon Islands
sbc	Papua New Guinea
mmo	Papua New Guinea
mmn	Philippines
sbf	Ethiopia
mmh	Brazil
mmk	India
mmj	India
sbj	Chad
mmd	China
mmg	Vanuatu
mmf	Nigeria
sbn	Pakistan
sbo	Malaysia (Peninsular)
sbl	Philippines
mmb	Indonesia (Papua)
prs	Afghanistan	Iran	Pakistan
NOCODE_Nigilu	Papua New Guinea
tou	Viet Nam
koi	Russian Federation (Asia)
koh	Congo
koj	Central African Republic
kol	Papua New Guinea
koo	Democratic Republic of the Congo	Uganda
koa	Papua New Guinea
koc	Nigeria
koe	Sudan	Ethiopia
kod	Indonesia (Papua)
kog	Colombia
kof	Nigeria
koy	United States
kox	Colombia
koz	Papua New Guinea
cfg	Nigeria
koq	Congo	Gabon
kop	Papua New Guinea
kos	United States	Nauru	Micronesia
kor	Canada	Brazil	Northern Mariana Islands	Panama	Mongolia	Uzbekistan	Suriname	Turkmenistan	Bahrain	Brunei	Saudi Arabia	Australia	Singapore	American Samoa	China	Germany	Belize	Kazakhstan	Mauritania	Kyrgyzstan	Libya	Philippines	United States	Thailand	New Zealand	Korea	North	Guam	Korea	South	Russian Federation (Asia)	Mozambique	Paraguay	Japan	Tajikistan
kou	Chad
kot	Cameroon	Chad
kow	Nigeria
kov	Nigeria
NOCODE_Southern-Khanty	Russian Federation (Asia)
qlm	Costa Rica
cfa	Nigeria
NOCODE_Puruguay	Ecuador
NOCODE_Maragua	Brazil
NOCODE_Gurinji-Kriol	Australia
vnm	Vanuatu
vnk	Solomon Islands
NOCODE_Dagang-Biao	China
fgr	Chad
vnp	Vanuatu
NOCODE_Natu	Brazil
NOCODE_Nati	Vanuatu
NOCODE_Colac	Australia
aeq	Pakistan
aes	United States
NOCODE_Menien	Brazil
aeu	Thailand	China	Myanmar	Laos
NOCODE_Adhari	Azerbaijan
iks	Canada
ikr	Australia
ikp	Nigeria
ikw	Nigeria
ikv	Nigeria
ikt	Canada
ikz	Tanzania
ikx	Uganda
ike	Canada
ikk	Nigeria
iki	Nigeria
iko	Nigeria
NOCODE_Yemeni-Sign	Yemen
ikl	Nigeria
lbq	Papua New Guinea
NOCODE_Samoan-Plantation-Pidgin	Samoa
lbs	Libya
NOCODE_Timote-Cuica	Venezuela
rab	Nepal
lbt	Viet Nam	China
lbv	Papua New Guinea
lby	Australia
rao	Papua New Guinea
NOCODE_Calusa	United States
lbz	Australia
gaz	Egypt	Ethiopia
gay	Indonesia (Papua)
gax	Ethiopia	Somalia	Kenya
gaw	Papua New Guinea
gav	Papua New Guinea
gau	India
gat	Papua New Guinea
gas	India
gar	Papua New Guinea
gaq	India
NOCODE_Vazimba	Madagascar
gao	Papua New Guinea
gan	China
gam	Papua New Guinea
gal	East Timor
gak	Indonesia (Papua)
gaj	Papua New Guinea
gai	Papua New Guinea
gah	Papua New Guinea
gag	Ukraine	Romania	Moldova	Russian Federation (Asia)	Kazakhstan	Bulgaria
gaf	Papua New Guinea
gae	Brazil	Venezuela
gad	Philippines
gab	Chad
gaa	Ghana
fuv	Nigeria	Cameroon	Chad
rav	Nepal
fut	Vanuatu
fuu	Democratic Republic of the Congo	Central African Republic
fur	Italy
NOCODE_Capoxo	Brazil
fuq	Niger
lbc	China
fuy	Papua New Guinea
fuf	Gambia	Senegal	Guinea-Bissau	Mali	Guinea	Sierra Leone
fud	Wallis and Futuna	New Caledonia
fue	Togo	Nigeria	Benin
fub	Sudan	United States	Nigeria	Cameroon	Chad
fuc	Mauritania	Gambia	Senegal	Guinea-Bissau	Mali	Guinea
fun	Brazil
rar	United States	New Zealand	French Polynesia	Cook Islands
fum	Nigeria
fuj	Sudan
fuh	Niger	Burkina Faso	Benin
fui	Central African Republic	Chad
lbg	Myanmar
lbf	India	China
ewo	Cameroon
tqb	Brazil
tql	Vanuatu
tqm	Papua New Guinea
tqn	United States
tqo	Papua New Guinea
ewe	Ghana	Togo
tqt	Mexico
tqu	Solomon Islands
tqw	United States
tqp	Papua New Guinea
tqq	Somalia
tqr	Sudan
lbn	United States	Thailand	Laos
NOCODE_Mpra	Ghana
syc	Turkey (Asia)
syb	Philippines
sya	Indonesia (Papua)
dga	Ghana
dgg	Papua New Guinea
dgd	Burkina Faso
dge	Papua New Guinea
syk	Nigeria
dgk	Central African Republic	Chad
dgh	Nigeria
dgi	Burkina Faso
dgn	Australia
dgo	India
sym	Burkina Faso
syl	Canada	United States	Australia	Italy	Bangladesh	Myanmar	Singapore	Malaysia (Peninsular)	India	United Kingdom
sys	Sudan	Chad
dgs	Côte d'Ivoire	Burkina Faso
syw	Nepal
dgu	India
dgz	Papua New Guinea
syy	Israel
syx	Gabon
NOCODE_Ngala-Santandrea	Sudan
jbu	Nigeria	Cameroon
jbt	Brazil
jbr	Indonesia (Papua)
jbe	Israel
NOCODE_Older-Runic	India
jbn	Tunisia	Libya
jbk	Papua New Guinea
jbj	Indonesia (Papua)
ldb	Nigeria
ldg	Nigeria
ldd	Nigeria
ldk	Nigeria
ldj	Nigeria
ldi	Congo	Angola
ldh	Nigeria
ldo	Nigeria
ldm	Guinea
ldl	Nigeria
ldq	Nigeria
ldp	Nigeria
cuw	Nepal
cuv	Cameroon
rgr	Peru
cut	Mexico
cur	Nepal
cuq	China
cup	United States
cux	Mexico
cug	Cameroon
rga	Vanuatu
NOCODE_Jumano	Mexico
rge	Greece
cua	Viet Nam
cuo	Venezuela
cun	Guatemala
NOCODE_Jumana	Colombia
rgk	India
cuk	Panama
cuj	Peru
cui	Venezuela	Colombia
cuh	Kenya
bin	Nigeria
bio	Papua New Guinea
bil	Nigeria
bim	Ghana
bij	Nigeria
qwh	Peru
bif	Guinea-Bissau
big	Papua New Guinea
bid	Chad
bie	Papua New Guinea
bib	Ghana	Togo	Côte d'Ivoire	Burkina Faso
bic	Papua New Guinea
qwa	Peru
bia	Australia
biz	Democratic Republic of the Congo
bix	India
biy	India
biv	Ghana	Côte d'Ivoire
biw	Cameroon
bit	Papua New Guinea
biu	India
bir	Papua New Guinea
bis	New Caledonia	Vanuatu
bip	Democratic Republic of the Congo
biq	Papua New Guinea
NOCODE_Kaniet-Dempwolff	Papua New Guinea
NOCODE_Remo-Blanco-River	Peru
NOCODE_Quinigua	Mexico
NOCODE_Guyana-Sign	Guyana
apl	United States
NOCODE_Tijuana-Sign	Mexico
pex	Papua New Guinea
pey	Indonesia (Papua)
pez	Brunei	Malaysia (Peninsular)
pev	Venezuela
pep	Papua New Guinea
NOCODE_Tolai-Nakanai-Trade	Papua New Guinea
pes	Canada	Qatar	Turkmenistan	France	Bahrain	Uzbekistan	Israel	Australia	Iran	Germany	Denmark	Iraq	Spain	Turkey (Asia)	Netherlands	Oman	Saudi Arabia	United States	Sweden	Syria	United Arab Emirates	India	Azerbaijan	United Kingdom	Austria	Greece	Tajikistan
pel	Indonesia (Papua)
pem	Democratic Republic of the Congo
peo	Iran
peh	China
pei	Mexico
pej	United States
pek	Papua New Guinea
ped	Papua New Guinea
pee	Indonesia (Papua)
pef	United States
peg	India
pea	Indonesia (Papua)
peb	United States
ufi	Papua New Guinea
bsq	Liberia	Sierra Leone
NOCODE_Xinca-Yupiltepeque	Guatemala
NOCODE_Imbabura	Ecuador
nsh	Cameroon
nsi	Nigeria
nsk	Canada
nsl	Norway
nsm	India
nsn	Papua New Guinea
nso	Botswana	South Africa
nsa	India
nsc	Nigeria
nsd	China
nse	Zambia	Zimbabwe	Mozambique
nsf	China
nsg	Tanzania
nsx	Angola
nsy	Indonesia (Papua)
nsz	United States
nsp	Nepal
nsq	United States
nsr	Canada
nss	Papua New Guinea
nst	India	Myanmar
nsu	Mexico
nsv	China
nsw	Vanuatu
mkg	China
mkf	Nigeria
mke	India
mkd	Canada	Albania	Serbia	Macedonia	United States	Slovenia	Croatia	Greece	Bulgaria
mkc	Papua New Guinea
mkb	India
mka	Côte d'Ivoire
mko	Nigeria
mkn	Indonesia (Papua)
mkm	Thailand
mkl	Benin
mkk	Cameroon
mkj	Micronesia
mki	Pakistan	India
mkw	Congo
mkv	Vanuatu
mku	Guinea	Liberia
mkt	New Caledonia
dgb	Mali
mkr	Papua New Guinea
mkq	United States
mkp	Papua New Guinea
mkz	East Timor
mky	Indonesia (Papua)
mkx	Philippines
sdt	France
sdu	Indonesia (Papua)
sdp	India
sdr	Bangladesh
sds	Tunisia
NOCODE_Bonari	Brazil
sdx	Malaysia (Peninsular)
sdz	Netherlands
sde	Nigeria
dgc	Philippines
sdg	Afghanistan	Pakistan
sda	Indonesia (Papua)
sdb	Iraq
sdc	Italy
sdl	Saudi Arabia
sdm	Indonesia (Papua)
sdn	Italy
sdo	Indonesia (Papua)	Malaysia (Peninsular)
sdh	Iraq	Iran
sdj	Congo
sdk	Papua New Guinea
zhw	Cameroon
zhb	China
zhd	Viet Nam	China
zhi	Nigeria
zhn	China
lyg	India
lya	Bhutan
tvd	Nigeria
lyn	Namibia	Zambia	Angola	Botswana
kqs	Guinea	Sierra Leone
kqr	Malaysia (Peninsular)
kqq	Brazil
kqp	Chad
kqw	Papua New Guinea
kqv	Indonesia (Papua)	Malaysia (Peninsular)
kqu	South Africa
kqt	Malaysia (Peninsular)
kqz	South Africa
kqy	Ethiopia
kqx	Cameroon	Chad
kqc	Papua New Guinea
kqb	Papua New Guinea
kqa	Papua New Guinea
kqg	Côte d'Ivoire	Burkina Faso
kqf	Papua New Guinea
kqe	Philippines
kqd	Iraq
kqk	Benin
kqj	Papua New Guinea
kqi	Papua New Guinea
kqh	Tanzania
kqo	Liberia
kqn	Democratic Republic of the Congo	Zambia
kqm	Côte d'Ivoire	Burkina Faso
kql	Papua New Guinea
NOCODE_Yao	Venezuela
xbx	Brazil
xbw	Brazil
xbr	Indonesia (Papua)
xbo	Russian Federation (Asia)
xbn	Malaysia (Peninsular)
xbi	Papua New Guinea
xba	Brazil
xbc	Afghanistan
tdi	Indonesia (Papua)
vlp	Vanuatu
vls	Belgium	Canada	Netherlands	United States	France
vlr	Vanuatu
pkc	South Korea
NOCODE_Peba	Peru
NOCODE_Keresan-Pueblo-Sign	United States
NOCODE_Icelandic-Basque-Pidgin	Iceland
NOCODE_Athima	Australia
NOCODE_Akpondu	Nigeria
NOCODE_Faeto-Celle-San-Vito-Francoprovencal	Italy
NOCODE_Guaicaro	Argentina
dgr	Canada
cha	United States	Guam	Northern Mariana Islands
chb	Colombia
NOCODE_Kwoma-Manambu-Pidgin	Papua New Guinea
chd	Mexico
che	Turkey (Asia)	Uzbekistan	Kyrgyzstan	Georgia	Russian Federation (Asia)	Jordan	Syria	Germany	Kazakhstan
chf	Mexico
chg	Turkmenistan
chh	United States
chj	Mexico
chk	United States	Guam	Micronesia
chl	United States
chn	Canada	United States
cho	United States
chp	Canada
chq	Mexico
chr	United States
chs	United States
cht	Peru
chu	Russian Federation (Asia)
chv	Russian Federation (Asia)	Uzbekistan	Kyrgyzstan	Kazakhstan	Estonia
chw	Mozambique
chx	Nepal
chy	United States
chz	Mexico
NOCODE_Kara	Ecuador
iii	China
tdg	Nepal
tde	Mali
gcc	Papua New Guinea
afo	Nigeria
gce	United States
afi	Papua New Guinea
afk	Papua New Guinea
afd	Papua New Guinea
afe	Nigeria
afg	Afghanistan
gcl	Grenada
afb	Bahrain	Qatar	Yemen	Iran	Oman	Egypt	United Arab Emirates	Saudi Arabia	Kuwait	Iraq
gcn	Papua New Guinea
gcr	French Guiana
gct	Venezuela
afz	Indonesia (Papua)
aft	Sudan
afu	Ghana
afp	Papua New Guinea
afr	Canada	Australia	South Africa	Zambia	Malawi	United States	Lesotho	Zimbabwe	Namibia	Swaziland	New Zealand	Botswana
afs	United States	Mexico
dwr	Ethiopia
dww	Papua New Guinea
NOCODE_Apiaka-Tocantins	Brazil
NOCODE_Nese	Vanuatu
bjd	Australia
NOCODE_Macao-Pidgin-Portuguese	China
NOCODE_Guachi	Brazil
tsn	Zimbabwe	Namibia	Botswana	South Africa
tso	Zimbabwe	Mozambique	Swaziland	South Africa
tsl	Viet Nam
tsm	Turkey (Asia)
tsj	India	China	Bhutan
tsk	Nepal	China	Bhutan
tsh	Cameroon
tsi	Canada	United States
tsf	Nepal
tsg	Indonesia (Papua)	Philippines	Malaysia (Peninsular)
tsd	Greece
tse	Tunisia
tsb	Ethiopia
tsc	Zimbabwe	Mozambique	South Africa
tsa	Congo	Gabon
tsz	United States	Mexico
tdx	Madagascar
tsy	Mali
tsv	Gabon
tsw	Nigeria
tst	Mali
tsu	Taiwan
tsr	Vanuatu
tss	Taiwan
eus	Australia	Mexico	Philippines	Costa Rica	France	United States	Spain
tsq	Thailand
dgx	Papua New Guinea
dae	Cameroon
daf	Guinea	Côte d'Ivoire	Liberia
dag	Ghana
daa	Chad
dac	Papua New Guinea
dal	Kenya
dam	Nigeria
dan	Canada	Greenland	United Arab Emirates	United States	Sweden	Germany	Denmark	Norway
dao	Myanmar
dah	Papua New Guinea
dai	Chad
daj	Sudan
dak	Canada	United States
dau	Sudan	Chad
dav	Kenya
daw	Philippines
dap	India
daq	India
dar	Turkey (Asia)	Ukraine	Kyrgyzstan	Turkmenistan	Azerbaijan	Russian Federation (Asia)	Uzbekistan	Kazakhstan
das	Côte d'Ivoire
NOCODE_Canari	Ecuador
dax	Australia
daz	Indonesia (Papua)
NOCODE_Lower-Riverland	Australia
sim	Papua New Guinea
NOCODE_Pirriya	Australia
lfa	Cameroon
lfn	United States
rey	Bolivia
rer	Ethiopia
res	Nigeria
NOCODE_Juri	Colombia
cwt	Senegal
ret	Indonesia (Papua)
rej	Indonesia (Papua)
rei	India
ren	Viet Nam
rel	Kenya
rem	Peru
cwa	Tanzania
rea	Papua New Guinea
cwe	Tanzania
reg	Tanzania
cwg	Malaysia (Peninsular)
ree	Malaysia (Peninsular)
bwp	Indonesia (Papua)
bwq	Burkina Faso
qus	Argentina
bws	Democratic Republic of the Congo
quu	Guatemala
qut	Guatemala
quw	Ecuador
bww	Democratic Republic of the Congo
quy	Peru
qux	Peru
bwz	Congo	Gabon
quz	Peru
tds	Indonesia (Papua)
qua	United States
bwa	New Caledonia
quc	Guatemala
qub	Peru
bwd	Papua New Guinea
bwe	Myanmar
qug	Ecuador
bwg	Mozambique
bwh	Cameroon
bwi	Brazil	Venezuela
bwj	Burkina Faso
bwk	Papua New Guinea
bwl	Democratic Republic of the Congo
qul	Bolivia	Peru
bwn	China
qun	United States
pgg	India
pga	Sudan
tdq	Nigeria
pgk	Vanuatu
pgi	Papua New Guinea
pgu	Indonesia (Papua)
pgs	Nigeria
pgy	Nepal
hat	Canada	United States	Cayman Islands	Bahamas	French Guiana	Puerto Rico	Dominican Republic	Guadeloupe	Turks and Caicos Islands	Haiti
udu	Sudan	Ethiopia
ogu	Nigeria
NOCODE_Muangphe	China
ogo	Nigeria
uda	Nigeria
udg	India
ude	Russian Federation (Asia)
udj	Indonesia (Papua)
ogg	Nigeria
udi	Russian Federation (Asia)	Georgia	Azerbaijan	Turkmenistan
hau	Ghana	Eritrea	Chad	Sudan	Nigeria	Central African Republic	Togo	Congo	Germany	Niger	Cameroon	Burkina Faso	Benin
udl	Cameroon
udm	Russian Federation (Asia)	Kazakhstan
hav	Democratic Republic of the Congo
nqg	Benin
nqk	Benin
nqn	Papua New Guinea
nqo	Liberia	Gambia	Mali	Sierra Leone	Senegal	Guinea-Bissau	Guinea	Côte d'Ivoire	Burkina Faso
tdt	East Timor
nqm	Indonesia (Papua)
mii	Mexico
mih	Mexico
mik	United States
mij	Cameroon
mim	Mexico
mil	United States	Mexico
mio	Mexico
min	Indonesia (Papua)
mia	United States
mic	Canada	United States
mib	Mexico
mie	Mexico
mid	United States	Iraq	Australia	Iran
mig	Mexico
mif	Cameroon
miy	Mexico
mix	United States	Mexico
miz	Mexico
NOCODE_Kuril-Ainu	Japan
miq	Nicaragua	Honduras
mip	Mexico
mir	Mexico
miu	Mexico
mit	Mexico
miw	Papua New Guinea
sfw	Ghana
sfs	South Africa
sfm	China
sfe	Philippines
sfb	Belgium
NOCODE_Jargon-Loucheux	Canada
ksu	India
kst	Burkina Faso
ksw	Thailand	Myanmar
ksv	Democratic Republic of the Congo
ksq	Nigeria
ksp	Central African Republic	Chad
kss	Liberia	Sierra Leone
ksr	Papua New Guinea
ksy	India
ksx	Indonesia (Papua)
ksz	India
kse	Papua New Guinea
ksd	Papua New Guinea
NOCODE_Calchaqui	Argentina
ksf	Cameroon
ksa	Nigeria
ksc	Philippines
ksb	Tanzania
ksm	Nigeria
ksl	Papua New Guinea
kso	Nigeria
ksn	Philippines
ksi	Papua New Guinea
ksh	Germany
ksk	United States
ksj	Papua New Guinea
xdc	Romania
NOCODE_Naxi-Yao	China
xdm	Jordan
xdy	Indonesia (Papua)
NOCODE_Bai-Maclay	Papua New Guinea
NOCODE_G\"uenoa	Uruguay
NOCODE_Naolan	Mexico
vrs	Solomon Islands
vrt	Vanuatu
NOCODE_Arizona-Tewa	United States
NOCODE_Marau-Wawa	Solomon Islands
vra	Vanuatu
NOCODE_Gulf-Coast-French	United States
qgu	Australia
NOCODE_Upper-Riverland	Australia
cop	Egypt
byf	Nigeria
cou	Guinea	Senegal
yso	China
ysn	China
ysl	Slovenia	Serbia
cov	China
ysg	India
ysd	China
ysy	China
cox	Peru
yss	Papua New Guinea
ysr	Russian Federation (Asia)
ysp	China
ilv	Nigeria
cjh	United States
cji	Russian Federation (Asia)
cjn	Papua New Guinea
cjo	Peru
cjm	United States	Viet Nam
NOCODE_Cosao	Laos	China
cja	Saudi Arabia	Australia	Libya	Viet Nam	Malaysia (Peninsular)	Cambodia	France	United States	Indonesia (Papua)	Thailand	Yemen
cje	United States	Viet Nam	France
cjy	China
cjr	Costa Rica
cjs	Russian Federation (Asia)
cjp	Costa Rica
cjv	Papua New Guinea
cod	Brazil	Peru	Colombia
iow	United States
iou	Papua New Guinea
cof	Ecuador
ior	Ethiopia
NOCODE_Neutral-Atiouandaronk	United States
wyr	Brazil
wyy	Fiji
wyb	Australia
wya	United States
wym	Poland
qvh	Peru
adw	Brazil
adt	Australia
gmh	Germany
gmo	Ethiopia
ads	Ghana
adp	Bhutan
adq	Ghana	Togo
gmb	Solomon Islands
gma	Australia
adz	Papua New Guinea
adx	China
ady	Turkey (Asia)	United States	Israel	Australia	Egypt	Macedonia	France	Russian Federation (Asia)	Netherlands	Germany	Syria	Jordan	Iraq
adf	Oman
adg	Australia
add	Nigeria	Cameroon
ade	Ghana	Togo
adb	East Timor
ada	Ghana
adn	Indonesia (Papua)
ado	Papua New Guinea
adl	India
adj	Côte d'Ivoire
gmv	Ethiopia
adh	Uganda
adi	India	China	Bhutan
njb	India
nja	Nigeria	Cameroon
njd	Tanzania
njj	Cameroon
nji	Australia
njh	India
njo	India
njn	India
njm	India
njl	Sudan
njs	Indonesia (Papua)
njr	Nigeria
nju	Australia
njt	Suriname
njz	India
njy	Congo	Cameroon
njx	Congo
tmp	Laos
tmq	Papua New Guinea
tmr	Iraq
tms	Sudan
tmt	Vanuatu
tmu	Indonesia (Papua)
esq	United States
tmw	Malaysia (Peninsular)
tmy	Papua New Guinea
tmz	Venezuela
tma	Sudan	Chad
ese	Bolivia	Peru
tmc	Chad
tmd	Papua New Guinea
tme	Brazil
tmf	Paraguay
tmg	Indonesia (Papua)
eso	Estonia
tmi	Vanuatu
tmj	Indonesia (Papua)
esl	Egypt
tml	Indonesia (Papua)
tmm	Viet Nam
tmn	Indonesia (Papua)
esh	Iran
dcc	India
NOCODE_Bokar	India
dcr	U.S. Virgin Islands
NOCODE_Girirra	Ethiopia
NOCODE_Aritinngitigh	Australia
rcf	Madagascar	Réunion	Comoros
buz	Nigeria
bux	Nigeria
buy	Guinea	Sierra Leone
bus	Nigeria
bup	Indonesia (Papua)
buq	Papua New Guinea
buv	Papua New Guinea
buw	Gabon
but	Papua New Guinea
buu	Democratic Republic of the Congo
buj	Nigeria
buk	Papua New Guinea
buh	China
bui	Congo
bun	Sierra Leone
buo	Papua New Guinea
bul	Canada	Turkey (Asia)	Israel	Czech Republic	Libya	Serbia	Romania	Moldova	Russian Federation (Asia)	United States	Croatia	Greece	Hungary	Ukraine	Slovakia	Bulgaria
bum	Cameroon
bub	Chad
buc	Mayotte
buf	Democratic Republic of the Congo
bug	Indonesia (Papua)	Malaysia (Peninsular)
bud	Ghana	Togo
bue	Canada
ccr	El Salvador
pih	Norfolk Island	Pitcairn	New Zealand	Australia	Fiji
pii	Australia
pij	Colombia
pil	Benin
pim	United States
pin	Papua New Guinea
pio	Venezuela	Colombia
pia	Mexico
pib	Peru
pic	Gabon
pid	Venezuela	Colombia
pie	United States
pif	United States	Guam	Micronesia
pig	Peru
pix	Papua New Guinea
piy	Nigeria
piz	New Caledonia
pip	Nigeria
pir	Brazil	Colombia
pis	Solomon Islands
pit	Australia
piu	Australia
piv	Solomon Islands
piw	Tanzania
oac	Russian Federation (Asia)
oaa	Russian Federation (Asia)	Japan
NOCODE_Mbour-Sign	Senegal
NOCODE_Aracaju	Brazil
oar	Syria
ubu	Papua New Guinea
ubr	Papua New Guinea
uby	Turkey (Asia)
uba	Nigeria
ubi	Chad
NOCODE_Pimenteira	Brazil
nwr	Papua New Guinea
scl	Pakistan	India
sco	United Kingdom	Ireland
nwe	Cameroon
nwa	United States
nwb	Côte d'Ivoire
nwm	Sudan
nwo	Australia
nwi	Vanuatu
mws	Kenya
mwq	Myanmar
mwp	Papua New Guinea
mww	Viet Nam	France	United States	China	Laos	Thailand
mwv	Indonesia (Papua)
mwu	Sudan
mwt	Thailand	Myanmar
mwz	Democratic Republic of the Congo
mwy	Tanzania
mwx	Tanzania
mwc	Papua New Guinea
mwb	Papua New Guinea
mwa	Papua New Guinea
mwg	Papua New Guinea
mwf	Australia
mwe	Tanzania
mwd	Australia
mwk	Mali
mwj	Angola
mwi	Vanuatu
NOCODE_Hottentot-Dutch	South Africa
mwo	Vanuatu
mnr	United States
mwm	Chad
mwl	Portugal
scf	Panama
NOCODE_Taensa	United States
sca	Myanmar
mnu	Indonesia (Papua)
brt	Nigeria	Cameroon
scb	Viet Nam	Laos
aix	Papua New Guinea
gcf	Guadeloupe	Martinique
NOCODE_Wavu-II	Togo
zdj	Madagascar	Réunion	Comoros
NOCODE_Yulparija	Australia
scy	Sweden
NOCODE_Yimas-Arafundi-Pidgin	Papua New Guinea
NOCODE_Pai-Lang	China
scw	Nigeria
aim	India
mnc	China
kuz	Chile
kuy	Australia
ail	Papua New Guinea
kuw	Central African Republic
kuv	Indonesia (Papua)
kuu	United States
kut	Canada	United States
kus	Ghana	Burkina Faso
kuq	Brazil
kup	Papua New Guinea
kuo	Papua New Guinea
kun	Eritrea	Ethiopia
kum	Russian Federation (Asia)	Turkey (Asia)	Kazakhstan
gna	Burkina Faso
kuk	Indonesia (Papua)
scs	Canada
kui	Brazil
kuh	Nigeria
kug	Nigeria
kuf	Laos
kue	Papua New Guinea
kud	Papua New Guinea
kuc	Indonesia (Papua)
kub	Nigeria	Cameroon
kua	Namibia	Angola
gng	Togo	Benin
gnd	Cameroon
zmk	Australia
xfa	Italy
aij	Israel
NOCODE_Palmela	Brazil
gnk	Botswana
gnh	Nigeria
aif	Papua New Guinea
wdd	Gabon
wdg	Papua New Guinea
gnn	Australia
wdj	Australia
zmm	Australia
wdu	Australia
aib	China
NOCODE_Hamba	Tanzania
NOCODE_Tawende	Brazil
NOCODE_Kawaway	Chad
bxz	Papua New Guinea
NOCODE_Sydney	Australia
NOCODE_Urupa	Brazil
ena	Papua New Guinea
enb	Kenya
enc	Viet Nam
end	Indonesia (Papua)
enf	Russian Federation (Asia)
eng	Canada	Saint Helena	Saint Pierre and Miquelon	Ethiopia	Aruba	Swaziland	Cameroon	Ghana	Saudi Arabia	Malaysia (Peninsular)	American Samoa	U.S. Virgin Islands	Dominica	Liberia	Jamaica	Tanzania	Cambodia	New Zealand	Pakistan	Samoa	Norfolk Island	United Arab Emirates	Guam	India	Lesotho	Saint Vincent and the Grenadines	Kenya	Falkland Islands	Northern Mariana Islands	Solomon Islands	Saint Lucia	Bermuda	Somalia	Vanuatu	Nauru	Norway	Malawi	Cook Islands	Singapore	Saint Kitts and Nevis	China	Dominican Republic	Bahrain	Tonga	Finland	Libya	Cayman Islands	Mauritius	British Virgin Islands	United States	South Africa	Tokelau	Turks and Caicos Islands	Mozambique	Uganda	Japan	Pitcairn	Bahamas	Gibraltar	Ireland	Palau	Nigeria	Ecuador	Brunei	Australia	Marshall Islands	Chile	Puerto Rico	Netherlands Antilles	Kiribati	Belize	Sierra Leone	Gambia	Philippines	Namibia	Malta	Switzerland	Grenada	Seychelles	Lebanon	Korea	South	Rwanda	Antigua and Barbuda	Fiji	Barbados	Madagascar	Italy	Nepal	Micronesia	Suriname	Anguilla	Venezuela	Israel	Zambia	Papua New Guinea	Zimbabwe	Germany	Denmark	Eritrea	British Indian Ocean Territory	Montserrat	Andorra	Trinidad and Tobago	Guyana	Guadeloupe	Honduras	Mexico	United Kingdom	Greece	Sri Lanka	Botswana	Niue
enh	Russian Federation (Asia)
enm	United Kingdom
enn	Nigeria
eno	Indonesia (Papua)
enq	Papua New Guinea
enr	Indonesia (Papua)
NOCODE_Old-Malay	Indonesia (Papua)
enu	China
env	Nigeria
enw	Nigeria
NOCODE_Ngkot	Australia
NOCODE_Kwisi	Angola
NOCODE_Theen	Laos
NOCODE_Yaruma	Brazil
ima	India
NOCODE_Jordanian-Bengali-Pidgin-Arabic	Jordan
clo	Mexico
clh	Pakistan
cli	Ghana
clk	India	China
cld	Canada	Turkey (Asia)	Australia	Lebanon	United States	Sweden	Netherlands	Germany	Belgium	Syria	Iraq
cle	Mexico
iml	United States
imo	Papua New Guinea
clc	Canada
imr	Indonesia (Papua)
cly	Mexico
clt	Myanmar
clu	Philippines
clw	Russian Federation (Asia)
NOCODE_Wayumara	Brazil
pbv	India	Bangladesh
NOCODE_Amami-Sign	Japan
gom	United Arab Emirates	India	Kenya
gol	Liberia	Sierra Leone
goo	Fiji
goi	Papua New Guinea
goh	Germany
gok	India
goj	India
ajp	Israel	Palestinian West Bank and Gaza	Libya	Egypt	Kuwait	Jordan	Puerto Rico	Syria	Argentina
NOCODE_Nanabin-Sign	Ghana
gog	Tanzania
gof	Ethiopia
ajt	Israel	Italy	Tunisia	France	United States	Spain
aju	Canada	Morocco	Israel	France
goc	Papua New Guinea
gob	Colombia
aji	New Caledonia
goy	Chad
gox	Democratic Republic of the Congo	Central African Republic
goz	Iran
gou	Cameroon
got	Moldova
gow	Tanzania
goq	Indonesia (Papua)
gop	Indonesia (Papua)
gos	Netherlands
ajg	Togo	Benin
nif	Papua New Guinea
pbl	Nigeria
NOCODE_Northern-Inland-Yuin	Australia
nhe	Mexico
nhd	Brazil	Paraguay	Argentina
nhg	Mexico
nhf	Australia
nha	Australia
nhc	Mexico
nhb	Côte d'Ivoire
nhm	Mexico
bgz	Indonesia (Papua)
nho	Papua New Guinea
nhn	Mexico
nhi	Mexico
nhh	India
nhk	Mexico
nhu	Cameroon
nht	Mexico
nhw	Mexico
nhv	Mexico
nhq	Mexico
nhp	Mexico
nhr	Namibia	Botswana
nhy	Mexico
nhx	Mexico
nhz	Mexico
toz	Cameroon	Central African Republic
tox	Palau
toy	Indonesia (Papua)
tor	Sudan	Democratic Republic of the Congo	Central African Republic
tos	Mexico
top	Mexico
toq	Sudan
tov	Iran
tow	United States
NOCODE_Yirandhali	Australia
toj	Mexico
toh	Mozambique
toi	Zambia	Zimbabwe
ton	Canada	Tonga	Australia	American Samoa	United States	Niue	Vanuatu	New Zealand	Fiji
too	Mexico
tol	United States
tom	Indonesia (Papua)
tob	Paraguay	Argentina	Bolivia
toc	Mexico
tof	Papua New Guinea
tog	Malawi
tod	Guinea
toe	Colombia
NOCODE_Eastern-Angkuic	China
NOCODE_Romanian-Pidgin-Arabic	Iraq
raf	Nepal
rag	Kenya	Tanzania
rad	United States	Viet Nam
lbr	Nepal
lbu	Papua New Guinea
rac	Indonesia (Papua)
lbw	Indonesia (Papua)
raa	Nepal
ran	Indonesia (Papua)
lbx	Indonesia (Papua)
ral	India	Myanmar
ram	Brazil
rak	Papua New Guinea
rah	India
rai	Papua New Guinea
lba	Myanmar
raw	India	Myanmar
rat	Iran
lbb	Papua New Guinea
lbe	Turkey (Asia)	Ukraine	Kyrgyzstan	Georgia	Turkmenistan	Kazakhstan	Azerbaijan	Russian Federation (Asia)	Uzbekistan	Tajikistan
ras	Sudan
rap	United States	French Polynesia	Chile
raq	Nepal
lbi	Cameroon
lbk	Philippines
lbj	India	China
raz	Indonesia (Papua)
rax	Nigeria
ray	French Polynesia
epo	Poland
NOCODE_Alacalufe-Austral	Chile
NOCODE_Xinca-Sinacantan	Guatemala
bsx	Nigeria
bsy	Malaysia (Peninsular)
bst	Ethiopia
bsu	Indonesia (Papua)
bsv	Guinea
bsw	Ethiopia
bsp	Guinea
qyp	United States
bsr	Nigeria
bss	Cameroon
bsl	Nigeria
bsm	Indonesia (Papua)
bsn	Colombia
bso	Chad
bsh	Afghanistan	Pakistan
bsi	Cameroon
bsj	Nigeria
NOCODE_Malaweg	Philippines
bse	Cameroon
bsf	Nigeria
bsg	Iran
bsa	Indonesia (Papua)
bsb	Brunei	Malaysia (Peninsular)
bsc	Gambia	Senegal	Guinea-Bissau	Guinea
pkr	India
pks	Pakistan
pkp	New Zealand	Australia	Cook Islands
pkt	Viet Nam	Laos
pku	Indonesia (Papua)
pkb	Kenya
NOCODE_Apolista	Bolivia
pkg	Papua New Guinea
pkh	India	Bangladesh	Myanmar
pkn	Australia
pko	Kenya	Uganda
oci	Monaco	Italy	Spain	France
och	China
oca	Peru	Colombia
NOCODE_Tshobdun	China
ocu	Mexico
NOCODE_Rengmitca	Bangladesh
nuz	Mexico
nux	Papua New Guinea
nuy	Australia
nuv	Burkina Faso
nuw	Micronesia
nut	Canada	United States	Australia	Viet Nam	Laos
nuu	Democratic Republic of the Congo
nur	Papua New Guinea
nus	Sudan	Ethiopia
nup	Nigeria
nuq	Papua New Guinea
nun	China	Myanmar
nuo	Viet Nam
nul	Indonesia (Papua)
num	Tonga
nuj	Uganda
nuk	United States
nuh	Nigeria
nui	Equatorial Guinea
nuf	China
nug	Australia
nud	Papua New Guinea
nue	Democratic Republic of the Congo
nuc	Brazil
nua	New Caledonia
muu	Kenya
mut	India
muv	India
muq	China
mup	India
mus	United States
mur	Sudan	Ethiopia
muy	Cameroon
mux	Papua New Guinea
muz	Ethiopia
mue	Ecuador
mud	Russian Federation (Asia)
mug	Cameroon	Chad
mua	Cameroon	Chad
muc	Cameroon
mub	Chad
mum	Papua New Guinea
muo	Nigeria	Cameroon
mui	Indonesia (Papua)
muh	Sudan	Democratic Republic of the Congo
muk	Nepal	India
muj	Chad
zbe	Malaysia (Peninsular)
zbc	Malaysia (Peninsular)
zbw	Malaysia (Peninsular)
zbt	Indonesia (Papua)
NOCODE_Warrnambool	Australia
kwa	Brazil
kwc	Congo
kwb	Nigeria
kwe	Indonesia (Papua)
kwd	Solomon Islands
kwg	Central African Republic	Chad
kwf	Solomon Islands
kwi	Ecuador	Colombia
kwh	Indonesia (Papua)
kwk	Canada	United States
kwj	Papua New Guinea
kwm	Namibia
kwl	Nigeria
kwo	Papua New Guinea
kwn	Namibia	Angola
kwq	Nigeria
kwp	Côte d'Ivoire
kws	Democratic Republic of the Congo
kwr	Indonesia (Papua)
kwu	Cameroon
kwt	Indonesia (Papua)
kww	Suriname
kwv	Central African Republic	Chad
kwy	Democratic Republic of the Congo	Angola
kwx	India
kwz	Angola
rth	Indonesia (Papua)
xxr	Brazil
xxt	Indonesia (Maluku)
xxb	Togo
xxk	Indonesia (Papua)
wfg	Indonesia (Papua)
NOCODE_Efatese	Vanuatu
NOCODE_Andro	Myanmar
rnn	Indonesia (Papua)
NOCODE_Sansimoniano	Bolivia
lcq	Indonesia (Papua)
NOCODE_Yarli	Australia
NOCODE_Brunca-Sign	Costa Rica
NOCODE_Dyarim	Nigeria
mmz	Democratic Republic of the Congo
mmu	Cameroon
elk	Papua New Guinea
elh	Sudan
lcm	Papua New Guinea
elo	Kenya
ell	Canada	Italy	Czech Republic	France	Bahamas	Democratic Republic of the Congo	Malawi	Turkey (Asia)	Russian Federation (Asia)	Australia	Austria	Jordan	Armenia	Germany	Kazakhstan	Sierra Leone	Ukraine	Georgia	Libya	Poland	Macedonia	United States	Sweden	Bulgaria	Romania	Albania	South Africa	Egypt	United Arab Emirates	United Kingdom	Tunisia	Djibouti	Congo	Mozambique	Greece	Paraguay	Hungary	Cyprus
elm	Nigeria
ele	Papua New Guinea
elx	Iran
elp	Indonesia (Papua)
elu	Papua New Guinea
bpb	Colombia
yww	Australia
ywu	China
ywt	China
ywr	Australia
ywq	China
jyy	Chad
jye	Israel	Yemen
ywa	Papua New Guinea
jya	China
ywn	Brazil
ywl	China
bpk	New Caledonia
qxi	Guatemala
bpm	Papua New Guinea
bpl	Australia
bpo	Indonesia (Papua)
NOCODE_Pidgin-Ngarluma	Australia
bpq	Indonesia (Papua)
cnt	Mexico
cnu	Algeria
cns	Indonesia (Papua)
bpp	Indonesia (Papua)
ica	Benin
bps	Philippines
cng	China
bpr	Philippines
cnb	Myanmar
cnc	Viet Nam
cna	India
icr	Colombia
cnl	Mexico
cnm	Guatemala	Mexico
cnk	India	Bangladesh	Myanmar
cnh	India	Bangladesh	Myanmar
qxw	Peru
hsb	United States	Germany
twb	Philippines
pys	Paraguay
hsf	Mexico
bpw	Papua New Guinea
hsh	Hungary
qxu	Peru
hsn	United States	China
hsl	Nigeria
pyu	Taiwan
hss	Oman
NOCODE_Chana	Uruguay
NOCODE_Navwien	Indonesia (Papua)
NOCODE_Daohua	China
ahb	Vanuatu
ppa	India
aha	Ghana
pyn	Brazil
ppe	Papua New Guinea
ppk	Indonesia (Papua)
ahk	Viet Nam	Thailand	China	Myanmar	Laos
ahh	Indonesia (Papua)
ahi	Côte d'Ivoire
ahn	Nigeria
aho	India
ppm	Indonesia (Papua)
ahm	Côte d'Ivoire
ahr	India
ppr	Indonesia (Papua)
ahp	Côte d'Ivoire
ppp	Democratic Republic of the Congo
twl	Mozambique
ppu	Taiwan
ppt	Papua New Guinea
giw	Viet Nam
giu	China
NOCODE_Tule-Kaweah	United States
gis	Cameroon
gir	Viet Nam
giq	Viet Nam
gip	Papua New Guinea
giz	Cameroon
giy	Australia
pye	Côte d'Ivoire
gig	Pakistan
gid	Cameroon	Chad
gic	South Africa
gib	Nigeria
NOCODE_Uirina	Brazil
gio	China
gin	Russian Federation (Asia)
gim	Papua New Guinea
gil	Solomon Islands	Tuvalu	United States	Vanuatu	Kiribati	Nauru	Fiji
NOCODE_Haush	Chile
NOCODE_Kipea	Brazil
nnn	Chad
nnm	Papua New Guinea
nnl	India
nnk	Papua New Guinea
nnj	Ethiopia
nni	Indonesia (Papua)
nnh	Cameroon
nng	India
nnf	Papua New Guinea
nne	Angola
nnd	Vanuatu
nnc	Chad
nnb	Democratic Republic of the Congo
nna	Australia
nnz	Cameroon
nny	Australia
nnx	Cameroon
nnw	Burkina Faso
nnv	Australia
nnu	Ghana
nnt	United States
nns	Nigeria
nnr	Australia
nnq	Tanzania
nnp	India
tix	United States
tiy	Philippines
tiz	China
tit	Colombia
tiu	Philippines
tiv	Nigeria	Cameroon
tiw	Australia
tip	Indonesia (Papua)
tiq	Burkina Faso
tir	Canada	Eritrea	Israel	Ethiopia	Djibouti	Germany
tis	Philippines
til	United States
tim	Papua New Guinea
tin	Russian Federation (Asia)
tio	Papua New Guinea
tih	Malaysia (Peninsular)
tii	Democratic Republic of the Congo
tij	Nepal
tik	Cameroon
tid	Indonesia (Papua)	Malaysia (Peninsular)
tie	Sudan
tif	Papua New Guinea
tig	Sudan	Eritrea
tia	Algeria
tic	Sudan
cnw	Myanmar
sqs	Sri Lanka
sqq	Laos
squ	Canada
sqt	United Arab Emirates	Yemen
sqk	Albania
ich	Nigeria
sqo	Iran
sqn	United States
sqm	Central African Republic
sqa	Nigeria
icl	Iceland
NOCODE_Betoi	Venezuela
roh	Switzerland
bze	Nigeria	Mali
lly	China
llx	Fiji
rol	Philippines
ron	Canada	Ukraine	Israel	Australia	Czech Republic	Uzbekistan	Tajikistan	Kyrgyzstan	Finland	Serbia	Azerbaijan	Moldova	Russian Federation (Asia)	United States	Romania	Croatia	Mozambique	Hungary	Kazakhstan	Turkmenistan
roo	Papua New Guinea
lls	Lithuania
rob	Indonesia (Papua)
llp	Vanuatu
rod	Nigeria
roe	Papua New Guinea
llu	Solomon Islands
rog	Viet Nam
llk	Malaysia (Peninsular)
lli	Congo
llh	China
llo	Laos
lln	Chad
llm	Indonesia (Papua)
lll	Papua New Guinea
llc	Guinea
llb	Mozambique
lla	Nigeria
llg	Indonesia (Papua)
llf	Papua New Guinea
lle	Papua New Guinea
row	Indonesia (Papua)
bqf	Guinea
bqg	Togo
bqd	Cameroon
bqb	Indonesia (Papua)
bqc	Nigeria	Benin
NOCODE_Mangio	Ethiopia
bqn	Bulgaria
bqo	Cameroon
bql	Papua New Guinea
bqm	Cameroon
bqj	Senegal
bqk	Sudan	Central African Republic
bqh	China
bqi	Iran
bqv	Nigeria
bqw	Nigeria
bqt	Cameroon
bqu	Sudan	Democratic Republic of the Congo
bqr	Indonesia (Papua)
bqs	Papua New Guinea
bqp	Nigeria
bqq	Indonesia (Papua)
bqz	Cameroon
bqx	Nigeria
bqy	Indonesia (Papua)
NOCODE_Luren	China
cno	Laos
NOCODE_Maza	China
NOCODE_Taruma	Brazil
NOCODE_Mpama	Democratic Republic of the Congo
NOCODE_Kukura	Brazil
NOCODE_Gubeeher-Gufangor-Gubelor	Nigeria
cni	Peru
der	India
pmt	French Polynesia
pmu	United Kingdom	India
pmw	United States
esn	El Salvador
pmr	Papua New Guinea
pms	United States	Australia	Italy
pmx	India
pmy	Indonesia (Papua)
pmz	Mexico
pme	New Caledonia
pmf	Indonesia (Papua)
pma	Vanuatu
pmb	Democratic Republic of the Congo
pmc	Indonesia (Papua)
pml	Tunisia
pmm	Congo	Cameroon
pmn	Cameroon
pmo	Indonesia (Papua)
pmh	India
pmi	China
pmj	China
kls	Pakistan
NOCODE_Aranama	United States
NOCODE_Forest-Nenets	Russian Federation (Asia)
esm	C\^ote d'Ivoire
msz	Papua New Guinea
msy	Papua New Guinea
msx	Papua New Guinea
msw	Gambia	Guinea-Bissau
msv	Cameroon	Chad
msu	Papua New Guinea
mst	Philippines
mss	Indonesia (Papua)
msr	Mongolia
msq	New Caledonia
msp	Brazil
mso	Indonesia (Papua)
msn	Vanuatu
msm	Philippines
msl	Indonesia (Papua)
msk	Philippines
msj	Democratic Republic of the Congo
msi	Malaysia (Peninsular)
msh	Madagascar
msg	Indonesia (Papua)
msf	Indonesia (Papua)
mse	Cameroon	Chad
msd	Mexico
msc	Guinea
msb	Philippines
sro	Italy
NOCODE_Duvle-Wano-Pidgin	Indonesia (Papua)
NOCODE_Panare-Trade-Spanish	Venezuela
bvu	Indonesia (Papua)
kyk	Philippines
kyj	Philippines
kyi	Malaysia (Peninsular)
kyh	United States
kyo	Indonesia (Papua)
kyn	Philippines
kym	Central African Republic
mgb	Chad
kyc	Papua New Guinea
kyb	Philippines
kya	Tanzania
kyg	Papua New Guinea
kyf	Côte d'Ivoire
kye	Ghana
kyd	Indonesia (Papua)
kyz	Brazil
kyy	Papua New Guinea
kyx	Papua New Guinea
kys	Malaysia (Peninsular)
kyr	Brazil
kyq	Chad
kyp	China	Laos
kyw	India
kyv	Nepal
kyu	Myanmar
kyt	Indonesia (Papua)
cob	Guatemala	Mexico
tbp	Indonesia (Papua)
mgi	Nigeria
csm	United States
mgh	Tanzania	Mozambique
mgo	Cameroon
mgn	Central African Republic
tbw	Philippines
NOCODE_Zbu	China
tbv	Papua New Guinea
tbi	Sudan
mgr	Tanzania	Zambia
NOCODE_South-Lucanian	Italy
mgq	Tanzania
NOCODE_Pacaguara-Mercier	Brazil
tbj	Papua New Guinea
NOCODE_Chatino-Sign	Mexico
tbm	Democratic Republic of the Congo
mgv	Tanzania
mgu	Papua New Guinea
tbn	Colombia
NOCODE_Arusha	Tanzania
mgy	Tanzania
ahg	Eritrea	Ethiopia
gta	Brazil
tbb	Brazil
gti	Democratic Republic of the Congo
vto	Indonesia (Papua)
ppi	Mexico
shp	Peru
ulm	Indonesia (Papua)
ppo	Papua New Guinea
ppn	Papua New Guinea
ahl	Togo
ppl	El Salvador
pps	Mexico
csv	Myanmar
ahs	Nigeria
shw	Sudan
ppq	Papua New Guinea
ppv	Brazil
aht	United States
NOCODE_Fayjatases	Chile
NOCODE_Ngala-Barth	Cameroon
eja	Senegal	Guinea-Bissau
NOCODE_Nouchi	C\^ote d'Ivoire
NOCODE_Querandi	Uruguay
git	Canada
yuy	China
yux	Russian Federation (Asia)
yuz	Bolivia
yuq	Bolivia
yup	Venezuela	Colombia
yus	Mexico
yur	United States
yuu	Russian Federation (Asia)
yut	Papua New Guinea
yuw	Papua New Guinea
yui	Brazil	Colombia
jwi	Ghana
yuk	United States
yuj	Papua New Guinea
yum	United States
yul	Sudan	Democratic Republic of the Congo	Central African Republic
yun	Nigeria
yua	Belize	Mexico
yuc	United States
yub	Australia
yue	Canada	Brunei	Australia	Honduras	Philippines	Viet Nam	Panama	Singapore	Malaysia (Peninsular)	Costa Rica	South Africa	United Kingdom	Indonesia (Papua)	Netherlands	China	Thailand	Nauru	Mauritius	New Zealand	United States
yud	Israel	Italy
yug	Russian Federation (Asia)
yuf	United States
tns	Papua New Guinea
gix	Democratic Republic of the Congo
tnr	Senegal
iai	New Caledonia
iap	Brazil
iar	Papua New Guinea
hud	Indonesia (Papua)
hue	Mexico
huf	Papua New Guinea
hug	Peru
gia	Australia
hub	Peru
huc	Botswana
hul	Papua New Guinea
hum	Democratic Republic of the Congo
hun	Canada	Ukraine	Israel	Australia	Czech Republic	Serbia	Romania	Russian Federation (Asia)	Slovenia	Austria	Croatia	Hungary	United States	Slovakia
huo	China
huh	Chile
hui	Papua New Guinea
huj	China
huk	Indonesia (Papua)
hut	Nepal
huu	Peru	Colombia
huv	Mexico
huw	Indonesia (Papua)
hup	United States
huq	China
hur	Canada	United States
hus	Mexico
hux	Peru
huy	United States	Israel	Iran
huz	Russian Federation (Asia)
esi	Canada	United States
dsl	Denmark
NOCODE_Vivti	Vanuatu
pre	São Tomé e Príncipe
prd	Afghanistan	Iran
prg	Poland
ang	United Kingdom
ana	Colombia
anb	Peru
anc	Nigeria
prm	Papua New Guinea
prl	Peru
ann	Nigeria
prn	Afghanistan
pri	New Caledonia
ani	Russian Federation (Asia)
prk	China	Myanmar
ank	Nigeria
ant	Australia
prt	Thailand	Laos
prw	Papua New Guinea
anw	Nigeria
prq	Peru
prp	United Kingdom	India	United States	China	Pakistan
anr	India
prr	Brazil
pry	Thailand
any	Ghana	Côte d'Ivoire
anz	Papua New Guinea
prz	Colombia
gkp	Guinea
gku	South Africa
gko	Australia
gkn	Nigeria
gka	Papua New Guinea
gke	Cameroon
fcs	Canada
NOCODE_Pasto	Ecuador
NOCODE_Old-Bangkok-Sign	Thailand
uya	Nigeria
NOCODE_Middle-Indo-Aryan	India
tkf	Brazil
tkg	Madagascar
tkd	East Timor
tke	Mozambique
tkb	India
tka	Brazil
nly	Australia
nlx	India
tkl	Tokelau	United States	New Zealand	American Samoa
tkm	United States
tkk	China
nla	Cameroon
tkw	Solomon Islands
tkt	Nepal	India
tku	Mexico
nle	Kenya
nld	Canada	Brazil	Netherlands	Indonesia (Papua)	South Africa	France	United States	Belgium	Germany	Suriname	Netherlands Antilles	Aruba
tkp	Solomon Islands
tkq	Nigeria
nli	Afghanistan
nlk	Indonesia (Papua)
nlj	Democratic Republic of the Congo
tkz	Viet Nam
nll	India
nlo	Democratic Republic of the Congo
nln	Mexico
NOCODE_Penange	Mali
ssy	Eritrea	Ethiopia
ssx	Papua New Guinea
ssz	Papua New Guinea
ssu	Papua New Guinea
sst	Papua New Guinea
ssw	Lesotho	Mozambique	Swaziland	South Africa
ssv	Vanuatu
ssq	Indonesia (Papua)
ssp	Spain
sss	Thailand	Laos
ssr	Switzerland
ssm	Malaysia (Peninsular)
dym	Mali
sso	Papua New Guinea
ssn	Kenya
ssi	Pakistan	India
dyi	Côte d'Ivoire
ssk	India
ssj	Papua New Guinea
dyd	Australia
ssd	Papua New Guinea
ssg	Papua New Guinea
dyg	Philippines
dya	Burkina Faso
ssc	Tanzania
ssb	Philippines	Malaysia (Peninsular)
luk	Bhutan
bvl	Bolivia
itz	Guatemala
rmr	Spain
rms	Romania
rmp	Papua New Guinea
rmq	Spain
rmw	United Kingdom
rmt	Turkey (Asia)	Afghanistan	Israel	Palestinian West Bank and Gaza	Iran	Libya	Egypt	India	Uzbekistan	Russian Federation (Asia)	Sudan	Jordan	Syria	Iraq
lnz	Democratic Republic of the Congo
rmz	India	Bangladesh
rmx	Viet Nam
rmy	Brazil	Canada	Italy	France	Slovakia	Argentina	Norway	Russian Federation (Asia)	Germany	Bosnia and Herzegovina	Chile	Spain	Ukraine	Netherlands	Poland	Moldova	United States	Sweden	Bulgaria	Romania	Albania	Portugal	Mexico	United Kingdom	Colombia	Greece
lns	Nigeria	Cameroon
lnm	Papua New Guinea
lnl	Democratic Republic of the Congo	Central African Republic
lno	Sudan
lnn	Vanuatu
rmf	Sweden	Finland
lnh	Malaysia (Peninsular)
rmd	Denmark
rme	United Kingdom	United States	Australia	South Africa
lnd	Brunei	Malaysia (Peninsular)	Indonesia (Papua)
rmh	Indonesia (Papua)
rmi	Russian Federation (Asia)	Syria	Azerbaijan	Armenia
lna	Democratic Republic of the Congo	Central African Republic
rmo	Netherlands	Italy	Czech Republic	Serbia	Poland	Montenegro	France	Slovenia	Austria	Croatia	Switzerland	Germany	Kazakhstan
rml	Ukraine	Belarus	Estonia	Poland	Lithuania	Russian Federation (Asia)	Latvia
rmm	Indonesia (Papua)
NOCODE_Ngubi	Gabon
NOCODE_Yinwum	Australia
pox	Germany
poy	Tanzania
pov	United States	Gambia	Senegal	Guinea-Bissau
pow	Mexico
pot	Canada	United States
pou	Guatemala
por	Brazil	Canada	Luxembourg	France	Andorra	Saint Vincent and the Grenadines	Bermuda	Mozambique	Suriname	Venezuela	Malawi	São Tomé e Príncipe	East Timor	Zambia	Indonesia (Papua)	China	Belgium	Germany	Spain	Oman	United States	Netherlands Antilles	Guinea-Bissau	Guyana	Switzerland	Cape Verde Islands	Jamaica	Angola	Portugal	Uruguay	South Africa	India	United Kingdom	Senegal	Congo	Antigua and Barbuda	Paraguay
NOCODE_Mabenaro	Peru
pop	New Caledonia
poq	Mexico
pon	Micronesia
poo	United States
pol	Canada	Czech Republic	Lithuania	Slovakia	Israel	Australia	Germany	Kazakhstan	Ukraine	Poland	Finland	United States	Latvia	Croatia	Belarus	Romania	Estonia	United Arab Emirates	Serbia	Azerbaijan	Russian Federation (Asia)	Austria	Hungary
pom	United States
NOCODE_Nasvang	Indonesia (Papua)
poh	Guatemala
poi	Mexico
pof	Democratic Republic of the Congo
pog	Brazil
pod	Colombia
poe	Mexico
pob	Guatemala
poc	El Salvador	Guatemala
poa	Guatemala
NOCODE_Ramanos	Bolivia
NOCODE_Coeruna	Colombia
mqa	Indonesia (Papua)
mqc	Indonesia (Papua)
mqb	Cameroon
mqe	Papua New Guinea
mqg	Indonesia (Papua)
mqf	Indonesia (Papua)
mqi	Indonesia (Papua)
mqh	Mexico
mqk	Philippines
mqj	Indonesia (Papua)
mqm	French Polynesia
mql	Benin
mqo	Indonesia (Papua)
mqn	Indonesia (Papua)
mqq	Malaysia (Peninsular)
mqp	Indonesia (Papua)
mqs	Indonesia (Papua)
mqr	Indonesia (Papua)
mqu	Sudan
mqt	Thailand
mqw	Papua New Guinea
mqv	Papua New Guinea
mqy	Indonesia (Papua)
mqx	Indonesia (Papua)
mqz	Papua New Guinea
quk	Peru
okv	Papua New Guinea
NOCODE_Maipure	Venezuela
NOCODE_Chairel	Myanmar
NOCODE_Alaguilac	Guatemala
NOCODE_Guamo	Venezuela
yhl	China
yha	China
yhd	United Kingdom	Israel	Iraq	India
wbv	Australia
wbw	Indonesia (Papua)
wbt	Australia
wbr	India
wbp	Australia
wbq	India
wbf	Burkina Faso
wbe	Indonesia (Papua)
wbb	Indonesia (Papua)
wba	Venezuela	Suriname	Guyana
wbl	Tajikistan	Afghanistan	China	Pakistan
wbm	China
wbj	Tanzania
wbk	Afghanistan
wbh	Tanzania
wbi	Tanzania
kve	Malaysia (Peninsular)
gvj	Brazil
gvn	Australia
gvo	Brazil
gvl	Chad
gvm	Nigeria
gvc	Brazil	Colombia
gva	Paraguay
gvf	Papua New Guinea
gve	Papua New Guinea
gvy	Australia
gvr	Nepal	India	Bhutan
gvs	Papua New Guinea
NOCODE_Apoto	Brazil
bbn	Papua New Guinea
bbl	Georgia
maq	Mexico
NOCODE_Cusabo	United States
sqh	Nigeria
NOCODE_Copallen	Peru
ehu	Nigeria
rmu	Sweden	Norway
jub	Nigeria
juc	China
jua	Brazil
jud	Côte d'Ivoire
juk	Nigeria
juh	Nigeria
jun	India
juo	Nigeria
jul	Nepal
jum	Sudan
jur	Brazil
jus	Nepal
jup	Brazil	Colombia
juw	Nigeria
jut	Denmark	Germany
juu	Nigeria
juy	India
cbb	Colombia
cbc	Brazil	Colombia
cbg	Colombia
cbd	Colombia
cbe	Colombia
cbj	Benin
cbk	Philippines
cbh	Colombia
cbi	Ecuador
cbn	Thailand
cbo	Nigeria
cbl	Myanmar
cbm	Guatemala
cbr	Peru
cbs	Brazil	Peru
cbq	Nigeria
cbv	Colombia
cbw	Philippines
cbt	Peru
cbu	Peru
cby	Colombia
igw	Nigeria
igg	Papua New Guinea
ige	Nigeria
igb	Nigeria
igo	Papua New Guinea
ign	Bolivia
igm	Papua New Guinea
igl	Nigeria
NOCODE_Roquetas-Pidgin-Spanish	Spain
hwo	Nigeria
hwc	United States
hwa	Côte d'Ivoire
tlu	Indonesia (Papua)
hmo	Papua New Guinea
tlt	Indonesia (Papua)
pto	Brazil
ptn	Indonesia (Papua)
all	India
alm	Vanuatu
alj	Philippines
alk	Laos
alh	Australia
ali	Papua New Guinea
alf	Nigeria
ald	Côte d'Ivoire
ale	United States
alc	Chile
pta	Paraguay
ala	Nigeria
alz	Democratic Republic of the Congo	Uganda
pty	India
aly	Australia
ptw	Canada
ptv	Vanuatu
alt	Russian Federation (Asia)
alu	Solomon Islands
alr	Russian Federation (Asia)
ptr	Vanuatu
alp	Indonesia (Papua)
alq	Canada
llq	Indonesia (Papua)
faz	Iran
fax	Spain
roc	Viet Nam
far	Solomon Islands
fap	Senegal
fau	Indonesia (Papua)
faj	Papua New Guinea
fak	Cameroon
fah	Nigeria
fai	Papua New Guinea
fan	São Tomé e Príncipe	Gabon	Congo	Cameroon	Equatorial Guinea
fao	United States	Denmark
fal	Cameroon
fam	Nigeria
fab	Equatorial Guinea
uwa	Australia
faa	Papua New Guinea
faf	Solomon Islands
fag	Papua New Guinea
fad	Papua New Guinea
and	Indonesia (Papua)
NOCODE_Homshetsma	Turkey (Asia)
teh	Argentina
tei	Papua New Guinea
nby	Papua New Guinea
tek	Democratic Republic of the Congo	Congo
tel	Bahrain	Canada	Singapore	United Arab Emirates	South Africa	India	Malaysia (Peninsular)	Mauritius	United States	Fiji
tem	Sierra Leone
ten	Colombia
teo	Kenya	Uganda
nbs	Namibia
tea	Malaysia (Peninsular)
nbq	Indonesia (Papua)
nbp	Nigeria
nbw	Democratic Republic of the Congo
tee	Mexico
tef	India
teg	Congo	Gabon
tex	Sudan
NOCODE_Light-Warlpiri	Australia
nbi	India
nbh	Nigeria
nbo	Nigeria
nbn	Indonesia (Papua)
nbm	Democratic Republic of the Congo	Congo	Central African Republic
nbl	South Africa
tep	Mexico
nbb	Nigeria
nba	Namibia	Zambia	Angola
tes	Indonesia (Papua)
tet	East Timor	Indonesia (Papua)
teu	Uganda
tev	Indonesia (Papua)
nbd	Democratic Republic of the Congo
sug	Papua New Guinea
sue	Papua New Guinea
suc	Philippines
sub	Democratic Republic of the Congo
sua	Papua New Guinea
sun	Indonesia (Papua)
sum	Nicaragua
sul	Philippines
suk	Tanzania
suj	Tanzania
sui	Papua New Guinea
rou	Central African Republic	Chad
suw	Tanzania
suv	India
sut	Nicaragua
sus	Guinea	Senegal	Sierra Leone	Guinea-Bissau
sur	Nigeria
suq	Sudan	Ethiopia
lld	United States	Italy
sbx	Indonesia (Papua)
suy	Brazil
sux	Iraq
sby	Zambia
NOCODE_Warekena-Velha	Brazil
mmm	Vanuatu
mml	China
NOCODE_Yanda	Australia
bqa	Benin
sba	Nigeria	Cameroon	Chad
mmi	Papua New Guinea
sbg	Indonesia (Papua)
rkt	India	Bangladesh
rkw	Australia
sbd	Burkina Faso
sbe	Papua New Guinea
mme	Vanuatu
rka	Cambodia
rkb	Brazil
sbk	Tanzania
rkm	Burkina Faso	Mali
rkh	New Zealand	Cook Islands
rki	Bangladesh	Myanmar
wkl	India
qcs	Mexico
sbi	Papua New Guinea
mma	Nigeria
mmc	Mexico
sbm	Tanzania
NOCODE_Malabar-Sri-Lanka-Portuguese	Sri Lanka	India
yva	Indonesia (Papua)
anl	Myanmar
NOCODE_Surgut-Khanty	Russian Federation (Asia)
anm	India	Myanmar
pzn	Myanmar
sce	China
NOCODE_Yambe	Congo
NOCODE_Tukang-Besi-Pidgin	Indonesia (Papua)
oyy	Papua New Guinea
NOCODE_Tallan	Peru
oym	Brazil	French Guiana
oyd	Ethiopia
oyb	Laos
NOCODE_Jenipapo-Kanind\'e	Brazil
lha	Viet Nam
lhn	Malaysia (Peninsular)
lhm	India	Nepal	China
lhl	India
lhi	United States	Thailand	China	Myanmar	Laos
lhh	Indonesia (Papua)
lhu	Viet Nam	Thailand	China	Myanmar	Laos
lht	Vanuatu
lhs	Syria
lhp	Bhutan
jit	Tanzania
NOCODE_Huetar	Costa Rica
jiu	China
ynl	Papua New Guinea
ynn	United States
yno	Thailand
ynh	Gabon
ynk	Russian Federation (Asia)
ynd	Australia
yne	China
yng	Democratic Republic of the Congo
yna	China
ynu	Colombia
ynq	Nigeria
yns	Democratic Republic of the Congo
mng	United States	Viet Nam
izh	Russian Federation (Asia)
izi	Nigeria
hab	Viet Nam
izr	Nigeria
anp	Nepal	India
NOCODE_Adurgari	Afghanistan
anq	India
wlx	Ghana
wly	Nepal
wlr	Vanuatu
wls	Wallis and Futuna	Fiji	New Caledonia	Vanuatu
wlu	Australia
wlv	Argentina	Bolivia
wlw	Indonesia (Papua)
wli	Indonesia (Papua)
wlk	United States
wll	Sudan
wln	Belgium
wlo	Indonesia (Papua)	Malaysia (Peninsular)
wla	Papua New Guinea
wlc	Madagascar	Réunion	Comoros
wle	Ethiopia
wlg	Australia
NOCODE_Nterato	Ghana
ans	Colombia
pmq	Mexico
gpn	Papua New Guinea
gpe	Ghana
gpa	Nigeria
ime	Mauritania
scv	Nigeria
efi	United States	Nigeria
efa	Nigeria	Cameroon
efe	Democratic Republic of the Congo
jsl	Japan
NOCODE_Gizey	Chad
scp	Nepal
NOCODE_Napeca	Bolivia
cdf	India
cdg	India
cda	China
rtm	Fiji
cdm	Nepal
cdn	Nepal	India
cdo	Brunei	Singapore	Malaysia (Peninsular)	United States	Indonesia (Papua)	China	Thailand
cdh	India
cdi	India
cdj	India
rtw	India
cdr	Nigeria
cds	Chad
mfd	Cameroon
NOCODE_Walangama	Australia
cdy	China
cdz	India	Bangladesh
bfc	China
bfb	India
bfa	Sudan	Uganda
bfg	Indonesia (Papua)
bff	Central African Republic
NOCODE_Pallanganmiddang	Australia
bfd	Cameroon
bfk	Thailand
bfj	Cameroon
bfi	United Kingdom
bfh	Papua New Guinea
bfo	Côte d'Ivoire	Burkina Faso
bfn	East Timor	Indonesia (Papua)
bfm	Cameroon
bfl	Sudan	Central African Republic
bfs	China
bfr	India
bfq	India
bfp	Cameroon
bfw	India
NOCODE_Catuquinaru-Bach	Brazil
bfu	India
bft	Pakistan	India
bfz	India
bfy	Nepal	India
bfx	Philippines
mfj	Cameroon
hir	Brazil
tcu	Mexico
hit	Turkey (Asia)
hiw	Vanuatu
hix	Brazil
mfm	Nigeria
hia	Nigeria
hib	Peru
hid	United States
mfn	Nigeria
hif	United States	Australia	Fiji
hig	Nigeria
hih	Papua New Guinea
hii	India
hij	Cameroon
hik	Indonesia (Papua)
hil	United States	Philippines
hin	Canada	United States	Yemen	Bangladesh	Bhutan	Singapore	United Arab Emirates	Philippines	Nepal	India	South Africa	United Kingdom	Djibouti	Germany	Uganda	Kenya	New Zealand	Belize	Botswana	Zambia
hio	Zimbabwe	Botswana
tcn	Nepal
tco	Myanmar
tcl	Myanmar
NOCODE_Omomil	United States
tcm	Indonesia (Papua)
mfu	Angola
arp	United States
arq	Algeria	Egypt	Saint Pierre and Miquelon	France	Germany	Belgium
arr	Brazil
ars	Canada	Saudi Arabia	Kuwait	United States	Jordan	Syria	Iraq
aru	Brazil
arv	Ethiopia
arw	Venezuela	French Guiana	Suriname	Guyana
arx	Brazil
ary	Netherlands	Libya	Western Sahara	Egypt	France	United Kingdom	Morocco	Germany	Gibraltar	Belgium
arz	Israel	Yemen	Libya	Egypt	United Arab Emirates	Saudi Arabia	Jordan	Kuwait	Syria	Iraq
mfw	Papua New Guinea
mfx	Ethiopia
arb	Qatar	Sudan	Kuwait	Somalia	Bahrain	Israel	Algeria	Jordan	Iraq	Eritrea	Palestinian West Bank and Gaza	Libya	Oman	Tanzania	Saudi Arabia	Morocco	Syria	Yemen	Chad	Egypt	United Arab Emirates	Lebanon	Tunisia	Djibouti	Comoros
ard	Australia
are	Australia
arg	Spain
arh	Colombia
ari	United States
arj	Brazil
ark	Brazil
arl	Peru
tcd	Ghana
arn	United States	Argentina	Chile
aro	Bolivia
txy	Madagascar
NOCODE_Wulwulam	Australia
uuu	China
NOCODE_Pollapese	Micronesia
uur	Vanuatu
uum	Ukraine	Georgia	Greece
uun	Taiwan
rof	Tanzania
NOCODE_Malali	Brazil
tgr	Laos
tgs	Vanuatu
tgp	Vanuatu
tgq	Malaysia (Peninsular)
tgv	Brazil
tgw	Côte d'Ivoire
tgt	Philippines
tgu	Papua New Guinea
tgz	Australia
tgx	Canada
tgy	Sudan
tgb	Malaysia (Peninsular)
tgc	Papua New Guinea
tga	Kenya
NOCODE_Laze	China
tgg	Papua New Guinea
tgd	Nigeria
tge	Nepal
tgj	India
tgk	Ukraine	Uzbekistan	Kyrgyzstan	Iran	Turkmenistan	Tajikistan	Russian Federation (Asia)	Kazakhstan
tgh	Trinidad and Tobago
tgi	Papua New Guinea
tgn	Philippines
tgo	Papua New Guinea
tgl	Canada	United States	Saudi Arabia	Libya	United Arab Emirates	Guam	United Kingdom	Philippines
duh	India
dui	Papua New Guinea
swk	Malawi
swj	Gabon
dul	Philippines
dum	Netherlands
swo	Brazil
swn	Libya
dua	Cameroon
swc	Democratic Republic of the Congo
swb	Mayotte	Madagascar	Réunion	Swaziland
swe	Canada	Estonia	United Arab Emirates	Finland	United States	Sweden	Denmark	Norway
due	Philippines
duf	New Caledonia
swf	Democratic Republic of the Congo	Central African Republic
swy	Chad
swx	Brazil
duz	Cameroon
dup	Indonesia (Papua)	Malaysia (Peninsular)
duq	Indonesia (Papua)
dur	Cameroon
swr	Indonesia (Papua)
swu	Indonesia (Papua)
duu	China
duv	Indonesia (Papua)
swv	India
skm	Papua New Guinea
NOCODE_Kpeego	Burkina Faso
rit	Australia
riu	Indonesia (Papua)
rir	Indonesia (Papua)
rin	Nigeria
ril	China	Myanmar
rim	Tanzania
rif	Netherlands	Algeria	France	Morocco	Germany	Belgium	Spain
NOCODE_Egbuta	Democratic Republic of the Congo
rie	Laos
bhs	Cameroon
ria	India	Bangladesh
imy	Turkey (Asia)
NOCODE_Picuris-Northern-Tiwa	United States
rop	Australia
NOCODE_Nyisu	China
ror	Indonesia (Papua)
lji	Indonesia (Papua)
ljl	Indonesia (Papua)
lje	Indonesia (Papua)
ljx	Australia
ljp	Indonesia (Papua)
NOCODE_Maritime-Polynesian-Pidgin	French Polynesia
NOCODE_Flecheiros	Brazil
NOCODE_Araicu	Brazil
zzj	Viet Nam	China
ylu	Papua New Guinea
ylr	Australia
yly	New Caledonia
ylg	Papua New Guinea
yle	Papua New Guinea
yla	Papua New Guinea
yln	China
ylo	China
yll	Papua New Guinea
ylm	China
yli	Indonesia (Papua)
NOCODE_Tapajo	Brazil
ixj	Guatemala
xpi	United Kingdom
ixi	Guatemala
xpo	Mexico
xpn	Brazil
xpm	Russian Federation (Asia)
xpc	Russian Federation (Asia)
ixc	Mexico
xpg	Turkey (Asia)
xpe	Liberia
xps	Turkey (Asia)
xpr	Iran
xpu	Tunisia
wnb	Papua New Guinea
wnc	Papua New Guinea
wng	Indonesia (Papua)
wnd	Australia
wne	Pakistan
wnk	Indonesia (Papua)
wni	Madagascar	Réunion	Comoros
wno	Indonesia (Papua)
wnm	Australia
wnp	Papua New Guinea
wnu	Papua New Guinea
wny	Australia
NOCODE_Maratino	Mexico
grv	Liberia
grw	Papua New Guinea
grt	India	Bangladesh
gru	Ethiopia
grr	Algeria
grs	Indonesia (Papua)
grq	Papua New Guinea
NOCODE_Xinca-Chiquimulilla	Guatemala
grz	Papua New Guinea
tpu	Cambodia	Laos
grx	Papua New Guinea
gry	Liberia
grg	Papua New Guinea
grd	Nigeria
grc	Greece
gra	India
gro	India	China
grm	Malaysia (Peninsular)
grj	Liberia	Côte d'Ivoire
grh	Nigeria
gri	Solomon Islands
NOCODE_Anggamuthi	Australia
NOCODE_Gudang	Australia
ojs	Canada
caz	Bolivia
jqr	Peru
hbb	Nigeria
iba	Brunei	Malaysia (Peninsular)	Indonesia (Papua)
caq	India
rro	Papua New Guinea
cfm	India	Bangladesh	Myanmar
rri	Solomon Islands
ibd	Australia
cfd	Nigeria
ibe	Nigeria
cat	Brazil	United States	Italy	Colombia	Algeria	Cuba	Mexico	France	Andorra	Switzerland	Uruguay	Germany	Chile	Belgium	Argentina	Venezuela	Dominican Republic	Spain
bde	Nigeria
bdd	Papua New Guinea
bdg	Malaysia (Peninsular)
bda	Gambia	Senegal	Guinea-Bissau
bdc	Colombia
bdb	Indonesia (Papua)
bdm	Nigeria	Cameroon	Chad
bdl	Indonesia (Papua)
bdo	Chad
bdn	Cameroon
bdi	Sudan
bdh	Sudan	Democratic Republic of the Congo
bdk	Azerbaijan
bdj	Sudan
bdu	Cameroon
bdt	Central African Republic
bdw	Indonesia (Papua)
bdv	India
bdq	United States	Viet Nam
bdp	Tanzania
bds	Tanzania
bdr	Malaysia (Peninsular)
bdy	Australia
bdx	Indonesia (Papua)
bdz	Pakistan
tcy	India
hks	China
hkk	Papua New Guinea
hka	Tanzania
caa	Guatemala	Honduras
hke	Democratic Republic of the Congo
ibu	Indonesia (Papua)
apz	Papua New Guinea
apx	Indonesia (Papua)
apy	Brazil
apr	Papua New Guinea
aps	Papua New Guinea
app	Vanuatu
apq	India
apv	Brazil
apw	United States
apt	India
apu	Brazil
apj	United States
apk	United States
aph	Nepal
api	Brazil
apn	Brazil
apo	Papua New Guinea
pxm	Mexico
apm	United States
apb	Solomon Islands
apc	Syria	Jamaica	Israel	Egypt	Puerto Rico	Lebanon	Turkey (Asia)	Trinidad and Tobago	Antigua and Barbuda	Suriname	Mali	French Guiana	Argentina	Belize	Cyprus	Dominican Republic
apf	Philippines
apg	Indonesia (Papua)
apd	Eritrea	Saudi Arabia	Libya	Ethiopia	Egypt	Sudan
ape	Papua New Guinea
usa	Papua New Guinea
kyl	United States
usk	Nigeria	Cameroon
usi	Bangladesh
ush	Pakistan
usu	Papua New Guinea
fer	Sudan
usp	Guatemala
NOCODE_Okwa	Ghana
NOCODE_Yokohama-Pidgin	Japan
spi	Indonesia (Papua)
NOCODE_Western-Jicaque	Nicaragua
NOCODE_Belueli	Democratic Republic of the Congo
tat	Turkey (Asia)	Afghanistan	Kyrgyzstan	Belarus	Turkmenistan	Estonia	Uzbekistan	Tajikistan	Finland	Lithuania	Azerbaijan	Latvia	Moldova	Russian Federation (Asia)	United States	Georgia	China	Kazakhstan	Ukraine
tau	Canada	United States
tav	Colombia
taw	Papua New Guinea
tap	Democratic Republic of the Congo	Zambia
taq	Burkina Faso	Algeria	Mali
tar	Mexico
tas	Viet Nam
tax	Chad
tay	Taiwan
taz	Sudan
tad	Indonesia (Papua)
tae	Brazil	Colombia
taf	Brazil
tag	Sudan
taa	United States
tab	Russian Federation (Asia)	Uzbekistan	Kazakhstan	Azerbaijan	Turkmenistan
tac	Mexico
tal	Nigeria
tam	Bahrain	Canada	Qatar	Netherlands	Singapore	United Arab Emirates	South Africa	India	Malaysia (Peninsular)	United Kingdom	United States	Réunion	Germany	Mauritius	Sri Lanka	Thailand	Fiji
tan	Nigeria
tao	Taiwan
tah	New Zealand	New Caledonia	French Polynesia	Vanuatu
taj	Nepal	India	Myanmar	Bhutan
tak	Nigeria
sis	United States
sir	Nigeria
siq	Papua New Guinea
sip	India
siw	Papua New Guinea
siv	Papua New Guinea
siu	Papua New Guinea
siz	Egypt
siy	Iran
six	Papua New Guinea
sic	Papua New Guinea
sib	Malaysia (Peninsular)
sia	Russian Federation (Asia)
dwa	Nigeria
sig	Ghana
sif	Côte d'Ivoire	Burkina Faso	Mali
sie	Zambia
sid	Ethiopia
sik	Brazil	Venezuela	Suriname
sij	Papua New Guinea
sii	India
sih	New Caledonia
sin	Canada	Maldives	Libya	Singapore	United Arab Emirates	United States	Sri Lanka	Thailand
dwl	Mali
sil	Ghana
NOCODE_Minkin	Australia
kbj	Democratic Republic of the Congo
kbk	Papua New Guinea
kbh	Colombia
kbi	Indonesia (Papua)
kbn	Cameroon	Central African Republic
kbo	Sudan	Democratic Republic of the Congo	Uganda
kbl	Chad
kbm	Papua New Guinea
kbb	Brazil
kbc	Brazil
kba	Australia
kbf	Chile
kbg	India
kbd	Turkey (Asia)	United States	Russian Federation (Asia)	Jordan	Syria	Germany
kbe	Australia
kbz	Nigeria
kbx	Papua New Guinea
kby	Niger	Nigeria
kbr	Ethiopia
kbs	Gabon
kbp	Ghana	Togo	Benin
kbq	Papua New Guinea
kbv	Indonesia (Papua)	Papua New Guinea
kbw	Papua New Guinea
kbt	Papua New Guinea
kbu	Pakistan
NOCODE_Mangar	Nigeria
byz	Papua New Guinea
byx	Papua New Guinea
byy	Democratic Republic of the Congo
byv	Cameroon
byw	Nepal
byt	Sudan
byr	Papua New Guinea
bys	Nigeria
byp	Nigeria
byq	Taiwan
byn	Eritrea
byo	China
byl	Indonesia (Papua)
bym	Australia
byj	Nigeria
byk	China
byh	Nepal
byi	Democratic Republic of the Congo
qgg	Jordan
byg	Sudan
byd	Indonesia (Papua)
bye	Papua New Guinea
byb	Cameroon
byc	Nigeria
bya	Philippines
NOCODE_Mithaka	Australia
NOCODE_Chiriva	Bolivia
rau	Nepal
NOCODE_Pisamira	Colombia
nfg	Nigeria
nfd	Nigeria
nfa	Indonesia (Papua)
nfl	Solomon Islands
nfk	Nigeria
nfu	Cameroon
nfr	Ghana	Côte d'Ivoire
NOCODE_Guwar	Australia
oui	China
oun	Angola
oum	Papua New Guinea
pqa	Nigeria
oub	Liberia	Côte d'Ivoire
oua	Algeria
oue	Papua New Guinea
NOCODE_Joaquiniano	Bolivia
soe	Democratic Republic of the Congo
NOCODE_Burkina-Faso-Sign	Burkina Faso
pqm	Canada	United States
lts	Kenya
ltu	Indonesia (Papua)
ltz	Belgium	United States	Germany	Luxembourg	France
ltc	China
lti	Indonesia (Papua)
lto	Kenya
ltn	Brazil
NOCODE_Chalon	United States
ybx	Papua New Guinea
yby	Papua New Guinea
NOCODE_Hawkesbury	Australia
ybh	Nepal	India
ybi	Nepal
ybj	Nigeria
ybk	China
ybl	Nigeria	Cameroon
ybm	Papua New Guinea
ybn	Brazil
ybo	Papua New Guinea
yba	Nigeria
ybb	Cameroon
ybd	Myanmar
ybe	China
xrn	Russian Federation (Asia)
xri	Brazil
xre	Brazil
xra	Brazil
xrb	Côte d'Ivoire	Burkina Faso
NOCODE_Bribri-Sign	Costa Rica
xru	Australia
xrw	Papua New Guinea
xrr	Italy
whg	Papua New Guinea
sol	Papua New Guinea
wha	Indonesia (Papua)
whk	Indonesia (Papua)
NOCODE_Ancient-Ligurian	Italy
NOCODE_Oropom	Uganda
NOCODE_Guinau	Brazil
NOCODE_Kankuamo	Colombia
NOCODE_Opon-Carare	Colombia
dmc	Papua New Guinea
thh	Mexico
ebg	Nigeria
ebo	Democratic Republic of the Congo	Congo
ebu	Kenya
ebr	Côte d'Ivoire
dlg	Russian Federation (Asia)
dlk	Eritrea
dln	India
dlm	Croatia
jor	Bolivia
jos	Jordan
jow	Burkina Faso	Mali
job	Democratic Republic of the Congo
jod	Côte d'Ivoire
NOCODE_Rundi-Kitwa	Rwanda
rpt	Papua New Guinea
myz	Iran
rpn	Vanuatu
bbo	Burkina Faso	Mali
NOCODE_Gambian-Sign	Gambia
bbm	Democratic Republic of the Congo
NOCODE_Yaru	Brazil
bbk	Cameroon
bbj	Cameroon
bbi	Cameroon
bbh	China
bbg	Gabon
bbf	Papua New Guinea
bbe	Democratic Republic of the Congo
bbd	Papua New Guinea
bbc	Indonesia (Papua)
bbb	Papua New Guinea
bba	Nigeria	Benin
bbz	Chad
bby	Cameroon
bbx	Cameroon
bbw	Cameroon
bbv	Papua New Guinea
bbu	Nigeria
bbt	Nigeria
bbs	Nigeria
bbr	Papua New Guinea
bbq	Cameroon
bbp	Sudan	Central African Republic
hmy	China
hmz	Viet Nam
hmt	Papua New Guinea
hmu	Indonesia (Papua)
hmv	Viet Nam
hmw	China
hmp	China
hmq	China
hmr	India
hms	China
hml	China
hmm	China
NOCODE_Bindal-Gorton	Australia
hmh	China
hmi	China
hmj	China
hmd	China
hme	China
hmf	Viet Nam
hmg	China
hma	China
hmb	Burkina Faso	Mali
hmc	China
mgc	Sudan
myl	Indonesia (Papua)
avt	Papua New Guinea
avu	Sudan	Democratic Republic of the Congo
avv	Brazil
avs	Peru
avl	Egypt	Syria	Israel	Palestinian West Bank and Gaza	Jordan
avn	Ghana
avo	Brazil
avi	Côte d'Ivoire
avk	United States
avd	Iran
ave	Iran
ava	Russian Federation (Asia)	Turkey (Asia)	Kazakhstan	Azerbaijan
avb	Papua New Guinea
fkk	Nigeria
tjg	Indonesia (Papua)
nod	Thailand	Laos
fkv	Norway
tjl	Myanmar
nob	Norway
tjn	Côte d'Ivoire
noy	Chad
mfa	Thailand
mfb	Indonesia (Papua)
mfc	Democratic Republic of the Congo
tcz	India	Myanmar
mfe	United Kingdom	Mauritius	Madagascar	France
tcx	India
mfg	Guinea
mfh	Cameroon
tcw	Mexico
tct	China
mfk	Cameroon
mfl	Nigeria
tcs	Australia
tcp	Myanmar
mfo	Nigeria
mfp	Indonesia (Papua)
mfq	Togo	Burkina Faso
mfr	Australia
mfs	Mexico
mft	Papua New Guinea
tck	Gabon
mfv	Gambia	Senegal	Guinea-Bissau	France
tci	Papua New Guinea
tcf	Mexico
tcg	Indonesia (Papua)
mfz	Sudan
tce	Canada
tcb	United States
tcc	Tanzania
tca	Brazil	Peru	Colombia
sku	Vanuatu
skt	Democratic Republic of the Congo
skw	Guyana
skv	Indonesia (Papua)
skq	Burkina Faso
skp	Malaysia (Peninsular)
sks	Papua New Guinea
skr	United Kingdom	Pakistan	India
sky	Solomon Islands
skx	Indonesia (Papua)
skz	Indonesia (Papua)
ske	Vanuatu
skd	United States
skg	Madagascar
skf	Brazil
ska	United States
skc	Papua New Guinea
skb	Thailand	Laos
tcq	Indonesia (Papua)
sko	Indonesia (Papua)
skn	Philippines
ski	Indonesia (Papua)
skh	Indonesia (Papua)
skk	Laos
skj	Nepal
NOCODE_Silla	South Korea
kdl	Nigeria
kdm	Nigeria
kdn	Zambia	Zimbabwe	Mozambique
kdh	Ghana	Togo	Benin
kdi	Uganda
kdj	Uganda
kdk	New Caledonia
kdd	Australia
kde	Tanzania	Mozambique
kdf	Papua New Guinea
kdg	Democratic Republic of the Congo
NOCODE_Bura-Sign	Nigeria
kdc	Tanzania
qer	Sweden
kdx	Nigeria
kdy	Indonesia (Papua)
kdz	Cameroon
kdt	Thailand	Cambodia	Laos
kdu	Sudan
kdv	Myanmar
kdw	Indonesia (Papua)
kdp	Nigeria
kdq	India	Bangladesh
kdr	Ukraine	Lithuania
NOCODE_Kaera	Indonesia (Maluku)
ndi	Nigeria	Cameroon
ndh	Tanzania	Malawi
ndk	Democratic Republic of the Congo
ndj	Tanzania
ndm	Chad
ndl	Democratic Republic of the Congo
ndo	Namibia	Angola
ndn	Congo	Central African Republic
nda	Congo	Gabon
ndc	Zimbabwe	Mozambique
ndb	Cameroon
nde	Zambia	Zimbabwe	Botswana
ndd	Nigeria
ndg	Tanzania
ndy	Central African Republic	Chad
ndx	Indonesia (Papua)
ndz	Sudan
ndq	Angola
ndp	Democratic Republic of the Congo	Uganda
nds	Germany
ndr	Nigeria	Cameroon
ndu	Cameroon
ndt	Democratic Republic of the Congo
ndw	Democratic Republic of the Congo
ndv	Senegal
owl	United Kingdom
owi	Papua New Guinea
vaj	Namibia
vah	India
vai	Liberia	Sierra Leone
van	Papua New Guinea
vao	Vanuatu
val	Papua New Guinea
vam	Papua New Guinea
vaa	India
vaf	Iran
vag	Ghana
vae	Central African Republic
vay	Nepal
var	Mexico
vas	India
vap	India
vav	India
vau	Democratic Republic of the Congo
bcl	Philippines
bch	Papua New Guinea
bci	Côte d'Ivoire
lvu	Indonesia (Papua)
NOCODE_Kainuu-Saami	Finland
hni	Viet Nam	China	Laos
lva	East Timor
hnh	Botswana
NOCODE_Womo-Sumararu	Papua New Guinea
lvk	Solomon Islands
myy	Brazil	Colombia
myx	Uganda
bcg	Guinea
myq	Côte d'Ivoire
myp	Brazil
mys	Ethiopia
myr	Peru
myu	Brazil
myt	Philippines
myw	Papua New Guinea
myv	Ukraine	Uzbekistan	Kyrgyzstan	Belarus	Turkmenistan	Estonia	Lithuania	Azerbaijan	Russian Federation (Asia)	Latvia	Armenia	Kazakhstan
myi	India
myh	United States
myk	Mali
myj	Sudan
mym	Ethiopia
hno	Pakistan
myo	Ethiopia
mya	United States	Thailand	Malaysia (Peninsular)	Bangladesh	Myanmar
myc	Democratic Republic of the Congo
myb	Nigeria	Central African Republic	Chad
mye	Gabon
myd	Papua New Guinea
myg	Cameroon
myf	Ethiopia
gap	Papua New Guinea
NOCODE_Calabrian-Greek	Greece
